mat_codigo,mfo_referencia,mat_descricao,mat_marca,Legenda,end_descricao,Est_Fisico,Est_Vendido,Est_Comprado,Disponivel
40037,20100201097609,AMERICANO JG COPO DE AGUA 190 ML,NADIR,Em linha,R04-B15-A00-P01,6846,456,0,6390
3010,102010021,AMERICANO COPO DE AGUA 190ML,NADIR,Em linha,R01-B13-A00-P01,61176,6000,41472,55176
40536,29100201243207    ,AMERICANO COPO C/ TAMPA E CANUDO 450 ML,NADIR,Em linha,R03-B10-A01-P03,493,0,0,493
3020,102310025,AMERICANO COPO DE APERITIVO 45 ML,NADIR,Em linha,R02-B22-A00-P01,11112,816,4104,10296
45233,51100201017411,AMERICANO XICARA CAFE C/ PIRES 90 ML,NADIR,Ponta de Estoque,R06-B24-A00-P01,1080,60,0,1020
31436,51100201015888,AMERICANO XICARA CAFE S/ PIRES 90 ML,NADIR,Em linha,R01-B04-A00-P03,1284,48,0,1236
28014,59100200981291,AMERICANO CANECA 270 ML,NADIR,Em linha,R02-B10-A00-P01,2232,360,0,1872
31437,42100201016223,AMERICANO TIGELA C/ TAMPA COLOR 150 ML ,NADIR,Promocao,R02-B13-A00-P01,5304,312,5712,4992
35580,41100201157923,AMERICANO TIGELA C/ TAMPA COLOR 350 ML,NADIR,Em linha,R04-B13-A00-P01,5904,732,6600,5172
55037,46100201476959,AMERICANO TIGELA C/ TAMPA COLOR 1 L,NADIR,Em linha,R03-B15-A00-P01,1932,564,4320,1368
35581,40100201146829,AMERICANO CJ TIGELA C/TPA COLOR 615 ML C/ 03 PCS,NADIR,Em linha,R04-B03-A00-P03,140,0,324,140
38056,15090201189546,AMERICANO JG TIGELAS C/ TAMPA 3PC,NADIR,Em linha,R04-B01-A01-P01,1164,12,0,1152
40535,54100201210018    ,"AMERICANO JARRA 1,2L",NADIR,Em linha,R01-B08-A00-P03,852,12,0,840
45226,20100201199154,COCA COLA JG C/6 AMERICANO COPO LINHA TEMPO 190 ML,NADIR,Em linha,R01-B06-A00-P02,208,0,0,208
38048,70500201184091,COPO COCA CONTOUR CRISTAL 470 ML,NADIR,Em linha,R03-B06-A01-P01,4908,84,0,4824
22234,78560200930312,BARONE TACA CHAMPANHE 190 ML,NADIR,Em linha,R03-B06-A01-P03,2244,60,0,2184
10461,78330200689688,IMPERATRIZ TACA P/ CHAMPAGNE 220 ML,NADIR,Em linha,R02-B10-A01-P01,2568,84,0,2484
9475,70330200635891,IMPERATRIZ TACA P/ AGUA 425 ML,NADIR,Em linha,R01-B03-A01-P01,2604,72,0,2532
9473,71330200635903,IMPERATRIZ TACA P/ VINHO TINTO 350 ML,NADIR,Em linha,R02-B06-A01-P02,1236,48,1584,1188
42170,J8010201237860,SM ROYAL TACA VINHO 320 ML,NADIR,Em linha,R08-B24-A00-P01,2700,96,0,2604
3954,78280200752149,WINDSOR TACA P/CHAMPAGNE 190 ML,NADIR,Em linha,R02-B05-A01-P02,1284,72,0,1212
3945,70280200758031,WINDSOR TACA P/AGUA 300 ML,NADIR,Em linha,R02-B10-A01-P03,96,24,1008,72
3947,107128012,WINDSOR TACA P/VINHO TINTO 250 ML,NADIR,Em linha,R02-B09-A01-P01,1764,48,0,1716
3953,107728010,WINDSOR TACA P/CERVEJA 330 ML,NADIR,Em linha,R02-B09-A01-P02,156,24,3024,132
11546,79280200728510,WINDSOR TACA P/ COQUETEL 380 ML,NADIR,Em linha,R02-B05-A01-P02,54,0,3024,54
16310,78630200897840,CELEBRA TACA DE CHAMPANHE 190 ML,NADIR,Promocao,R02-B08-A01-P02,4452,156,0,4296
28011,76510200962357,DUBLIN TACA CERVEJA GOURMET 400 ML,NADIR,Em linha,R01-B05-A01-P01,588,144,1800,444
39279,J7000201232241,SM BUFFET TACA AGUA 300 ML,NADIR,Em linha,R08-B15-A00-P01,7056,600,1728,6456
39281,J7010201232461,SM BUFFET TACA VINHO 260 ML,NADIR,Em linha,R09-B15-A00-P01,6120,672,0,5448
40545,J7000201252200,SM BUFFET JG C/ 6 COPO AGUA,NADIR,Em linha,R08-B22-A00-P01,174,6,0,168
9722,78340200570880,LIRIO TACA P/ CHAMPAGNE 180 ML,NADIR,Em linha,R01-B02-A01-P02,1116,12,0,1104
9930,70340200774250,LIRIO JG 06 PCS TACA P/ AGUA 365 ML  ,NADIR,Em linha,R03-B29-A00-P01,813,161,1260,652
9723,70340200570863 ,LIRIO TACA P/ AGUA 350 ML,NADIR,Em linha,R02-B27-A00-P01,1104,12,360,1092
9931,71340200774276,LIRIO JG 06 PCS TACA VINHO 250 ML,NADIR,Em linha,R03-B31-A00-P01,434,53,1344,381
9724,71340200570871,LIRIO TACA P/ VINHO 250 ML,NADIR,Em linha,R01-B01-A01-P03,3132,12,0,3120
51168,79480201438485,TAÇA GIN TONICA 600 ML JG C/ 4,NADIR,Em linha,R03-B09-A00-P02,624,50,2160,574
38062,79480201184551,TACA GIN TONICA 600 ML,NADIR,Em linha,R02-B30-A00-P01,3426,300,3744,3126
3929,107808072,GALLANT JG TACA FLAUTA 180 ML,NADIR,Em linha,R02-B04-A01-P01,421,18,0,403
3794,107808021,GALLANT TACA FLAUTA 180 ML,NADIR,Em linha,R03-B17-A00-P01,6348,180,0,6168
3745,107708027,GALLANT JG TACA DE AGUA 320 ML,NADIR,Em linha,R02-B03-A01-P01,58,0,0,58
3740,107708019,GALLANT TACA DE AGUA 320 ML,NADIR,Promocao,R03-B19-A00-P01,1980,12,0,1968
3735,70080200772801,GALLANT JG TACA DE VINHO TINTO 250 ML,NADIR,Em linha,R02-B01-A01-P03,22,2,168,20
3730,107008017,GALLANT TACA DE VINHO TINTO 250 ML,NADIR,Em linha,R03-B18-A00-P01,192,48,1440,144
3180,107702037,PAULISTA TACA DE CERVEJA 300 ML,NADIR,Em linha,R02-B18-A00-P01,2113,264,1512,1849
3190,70020200772123,PAULISTA JG TACA DE AGUA 250 ML,NADIR,Em linha,R02-B02-A01-P03,477,1,0,476
3150,107002027,PAULISTA TACA DE AGUA 250 ML,NADIR,Em linha,R02-B19-A00-P01,5040,96,5040,4944
7300,72040200773231,PAULISTA JG TACA PARA SORVETE C/ 03 PCS 400 ML,NADIR,Em linha,R02-B02-A01-P02,670,19,0,651
7299,107204010,PAULISTA TACA PARA SORVETE 400 ML,NADIR,Promocao,R02-B06-A01-P03,4368,24,0,4344
3160,107202018,PAULISTA TACA SOBREMESA 220 ML,NADIR,Em linha,R04-B04-A00-P02,3408,72,0,3336
40546,J4000201252226,SM CASUAL JG C/ 6 COPO AGUA,NADIR,Em linha,R09-B27-A00-P01,510,18,0,492
39282,J4000201232381,SM CASUAL TACA AGUA 260 ML,NADIR,Em linha,R08-B21-A00-P01,72,48,6120,24
39283,J4010201234896,SM CASUAL TACA VINHO 180 ML,NADIR,Em linha,R09-B26-A00-P01,4920,72,0,4848
39284,J4160201232073,SM FIRENZE COPO LONG DRINK 360 ML,NADIR,Em linha,R08-B26-A00-P01,3360,144,0,3216
39285,J4150201231812,SM FIRENZE COPO ROCKS 275 ML,NADIR,Em linha,R09-B25-A00-P01,4728,0,0,4728
45236,77320201338636,FLORIPA JG C/ 2 TACA CERVEJA DEC BRASAO 300 ML,NADIR,Em linha,R03-B03-A01-P01,774,0,0,774
34106,77320200762195,FLORIPA TACA CERVEJA DEC BRASAO 300 ML,NADIR,Em linha,R01-B07-A01-P01,2496,684,8568,1812
13033,72240200825109,CLUBE TACA SORVETE 400 ML,NADIR,Promocao,R03-B07-A01-P01,108,36,900,72
28012,00430200981478,MARINE TACA 340 ML,NADIR,Em linha,R01-B10-A00-P03,348,0,1200,348
29533,04430200981241,MARINE TACA SOBREMESA CRISTAL 300 ML,NADIR,Em linha,R01-B04-A01-P02,3120,0,0,3120
8225,00110200500101,BRISTOL TACA AGUA 340 ML,NADIR,Em linha,R01-B10-A00-P01,1080,0,0,1080
13209,21110200792722,BRISTOL COPO P/SUCO 200 ML,NADIR,Em linha,R03-B07-A01-P02,1464,0,0,1464
7317,25110200746259,BRISTOL COPO ROCKS 320 ML ,NADIR,Em linha,R01-B10-A01-P03,5268,12,0,5256
3976,59110200793952,BRISTOL CANECA P/CHOPP 340 ML,NADIR,Em linha,R03-B07-A00-P04,1320,36,0,1284
34105,59020200792714,TABERNA CANECA P/ CHOPP 600 ML,NADIR,Em linha,R03-B10-A00-P01,108,12,0,96
33245,59030201100046,OKTOBER CANECA P/ CHOPP 355 ML,NADIR,Em linha,R03-B07-A00-P02,624,12,0,612
3797,77010200625730,COPO CERVEJA/CHOPP CALDERETA 350 ML,NADIR,Em linha,R04-B02-A01-P02,684,0,0,684
3077,71010200625748,COPO CERVEJA/CHOPP CALDERETA 220 ML,NADIR,Em linha,R02-B35-A00-P01,1920,180,0,1740
45227,71010201323910,COPO CERVEJA/CHOPP CALDERETA BRAHMA 220 ML,NADIR,Em linha,R02-B07-A01-P01,2328,144,0,2184
7895,70200200755358,FREVO COPO CERVEJA 320 ML,NADIR,Em linha,R04-B06-A00-P02,1008,24,0,984
7896,71200200751197,FREVO COPO CERVEJA 220 ML,NADIR,Em linha,R01-B08-A01-P01,672,72,2400,600
8227,79090200509042,COPO CERVEJA/CHOPP MUNICH 500 ML,NADIR,Em linha,R03-B06-A01-P04,528,0,0,528
39287,J5070201230431,SM LAGER COPO 300ML,NADIR,Em linha,R09-B24-A00-P01,4152,504,0,3648
3250,77090200773484,COPO CERVEJA/CHOPP MUNICH JG 300 ML,NADIR,Em linha,R03-B09-A00-P01,342,0,144,342
3240,77090200764060,COPO CERVEJA/CHOPP MUNICH 300 ML,NADIR,Em linha,R02-B15-A00-P02,226,192,9072,34
3760,71090200771972,COPO CERVEJA MUNICHINHO JG 200 ML,NADIR,Em linha,R03-B08-A00-P01,243,0,0,243
3750,107109034,COPO CERVEJA MUNICHINHO 200 ML,NADIR,Em linha,R02-B16-A00-P01,19688,1440,4440,18248
45237,08310201150107,CJ 5 COPOS CERVEJAS ESPECIAIS,NADIR,Em linha,R04-B01-A01-P02,322,1,0,321
40548,J3060201252251,SM ARUBA JG C/ 6 COPO LONG DRINK,NADIR,Em linha,R09-B28-A00-P01,618,24,0,594
39273,J3050201234714,SM ARUBA COPO ROCKS 345 ML,NADIR,Em linha,R09-B21-A01-P01,2664,120,1716,2544
39277,J2580201237827,SM BROOKLYN COPO TUBO 300 ML,NADIR,Em linha,R09-B29-A00-P01,5280,48,0,5232
39274,J2560201237801,SM BROOKLYN COPO LONG DRINK,NADIR,Em linha,R08-B25-A00-P01,1536,240,0,1296
38052,77290201144452,OCA JG COPO LD 300ML 6PC  ,NADIR,Em linha,R03-B13-A00-P01,1284,198,0,1086
38051,77290201165034,OCA COPO 300 ML,NADIR,Em linha,R03-B10-A01-P01,1345,0,0,1345
7904,76290200531194,OCA COPO P/REFRESCO 400 ML,NADIR,Em linha,R01-B08-A00-P02,1032,24,0,1008
7902,75290200531186,OCA COPO P/WHISKI 330 ML,NADIR,Em linha,R03-B08-A01-P01,504,24,1560,480
56563,76640200898025,DUBAI COPO 480ML,NADIR,Em linha,R04-B07-A00-P02,1056,120,4440,936
40038,76040200769135,LIGTHS JG COPO LONG DRINK 410 ML,NADIR,Em linha,R03-B14-A00-P01,1500,186,384,1314
3033,107604035,LIGTHS COPO LONG DRINK 410 ML,NADIR,Em linha,R04-B08-A00-P02,1464,72,0,1392
3031,70040200747665,LIGHTS COPO DE AGUA 260 ML,NADIR,Promocao,R04-B07-A00-P01,2760,192,0,2568
7268,75040200758823,LIGHTS COPO ROCKS 290 ML,NADIR,Em linha,R01-B10-A01-P02,37416,0,0,37416
11103,73040200748828,LIGHTS TIGELA SOBREMESA 315 ML,NADIR,Em linha,R01-B10-A01-P01,960,0,0,960
55148,77040201144268,LIGTHS JG C/ 6 COPO 300 ML,NADIR,Em linha,R02-B34-A00-P01,9546,174,0,9372
40547,J2060201252269,SM MANCHESTER JG C/ 6 COPO AGUA,NADIR,Em linha,R08-B27-A00-P01,996,6,0,990
39288,J2060201237771,SM MANCHESTER COPO LONG DRINK 310 ML,NADIR,Em linha,R09-B23-A00-P01,17040,768,0,16272
3135,117600016,CYLINDER COPO LONG DRINK 350 ML,NADIR,Em linha,R04-B02-A00-P01,2304,0,0,2304
3038,107800020,CYLINDER COPO TUBO 320 ML,NADIR,Em linha,R01-B07-A01-P02,2160,0,0,2160
3035,77000200760982,CYLINDER COPO LONG DRINK 300 ML,NADIR,Em linha,R02-B32-A00-P01,2808,120,0,2688
3125,107505037,CYLINDER COPO ROCKS 320 ML,NADIR,Em linha,R01-B01-A00-P03,3072,0,0,3072
7888,76230200640462,ILHABELA LONG DRINK 400 ML,NADIR,Em linha,R01-B04-A01-P01,1644,0,0,1644
7303,79230200640471,ILHABELA PARA CAIPIROSKA 350 ML,NADIR,Em linha,R01-B02-A00-P03,156,12,1452,144
50433,77710201369643,PROSA COPO 300 ML,NADIR,Em linha,R03-B02-A01-P01,1608,48,0,1560
50434,77720201369635,POEMA COPO 300 ML,NADIR,Em linha,R03-B01-A01-P01,5952,24,0,5928
16384,16160200898084,MORINGA JARRA 500 ML C/ 02 PCS ,NADIR,Em linha,R01-B09-A01-P01,612,12,0,600
3046,27520200764844,VEGAS COPO LONG DRINK 330 ML,NADIR,Em linha,R04-B01-A00-P03,888,144,1536,744
3480,20520200635743,VEGAS COPO DE AGUA 240 ML,NADIR,Em linha,R04-B01-A00-P01,1608,24,2400,1584
3490,25520200635719,VEGAS COPO ROCKS 290 ML,NADIR,Em linha,R04-B01-A00-P02,1344,144,1080,1200
41122,26440201196324,CAIRO JG COPO 350 ML,NADIR,Em linha,R09-B18-A00-P01,3174,348,4320,2826
42152,26440201188332    ,CAIRO COPO 350 ML,NADIR,Em linha,R03-B23-A00-P01,47688,3912,22464,43776
42153,26450201193801    ,MARROCOS COPO 350ML,NADIR,Em linha,R09-B13-A00-P01,16680,2184,17280,14496
11547,77450200762742,BRISA COPO LONG DRINK C/ DETALHES 300 ML,NADIR,Em linha,R01-B03-A00-P01,2760,0,0,2760
3090,102606030,BAR COPO LONG DRINK 340 ML,NADIR,Em linha,R04-B05-A00-P01,2640,120,2880,2520
3070,102601054,BAR COPO LONG DRINK 260 ML,NADIR,Em linha,R04-B06-A00-P03,5208,72,4800,5136
3060,101800231,BAR COPO ROCKS 265 ML,NADIR,Em linha,R02-B33-A00-P01,8568,288,0,8280
3018,102148015,BAR COPO DE VINHO 150 ML,NADIR,Em linha,R02-B29-A00-P01,7128,240,0,6888
3050,30330100636480,BAR COPO DE APERITIVO 100 ML,NADIR,Promocao,R02-B21-A00-P01,5616,408,6144,5208
8237,54160100521236,JARRA BAR 780 ML,NADIR,Em linha,R03-B04-A01-P02,3828,216,864,3612
42171,54470201304840    ,"SM TANGO JARRA 1,5L",NADIR,Em linha,R09-B14-A00-P01,3078,582,3600,2496
56562,54230201348949,JARRA 1750 ML TROPICANA,NADIR,Em linha,R08-B28-A00-P01,1458,48,0,1410
42173,54460201300849    ,"SM ZUMBA JARRA C/ TAMPA 1,2L",NADIR,Em linha,R08-B20-A00-P01,6210,756,2520,5454
31446,54120201018000,"JARRA LADRILHO CRISTALINA C/TPA COLOR 1,2 LTS",NADIR,Em linha,R01-B04-A00-P02,696,6,0,690
12904,54180100571188,MARACATU JARRA 1500 ML,NADIR,Em linha,R03-B16-A00-P01,7128,1116,12000,6012
11992,13180200785733,MARACATU CJ REFRESCO C/ 05 PCS,NADIR,Em linha,R03-B27-A00-P01,1072,192,1280,880
55036,20490201514361,AMAZON JG C/ 6 COPO 190 ML,NADIR,Em linha,R03-B32-A00-P01,22040,1216,3840,20824
42174,J1360201304815,SM ZUMBA JG C/ 6 COPO CRISTALINO 270 ML,NADIR,Em linha,R08-B16-A00-P01,1505,912,35384,593
42163,J1160201304823,SM AURORA JG C/ 6 COPO CRISTALINO 270 ML,NADIR,Em linha,R08-B18-A00-P01,29232,992,7200,28240
42166,J1260201304831,SM NATURE JG C/ 6 COPO CRISTALINO 270 ML,NADIR,Em linha,R08-B17-A00-P01,1313,952,34976,361
11996,20210200946955,GINGA COPO INCOLOR JG C/ 6 PCS 265 ML,NADIR,Em linha,R04-B14-A00-P01,34528,520,0,34008
40035,20260200946971,LAGUNA COPO INCOLOR JG C/ 6 PCS 265 ML,NADIR,Em linha,R04-B16-A00-P01,35912,368,0,35544
8230,20180200946082,MARACATU COPO LOSANGO INCOLOR JG C/ 6 PCS 265 ML,NADIR,Em linha,R05-B13-A00-P01,34680,568,0,34112
8232,20190200946699,BATUQUE COPO TRIANGULO INCOLOR JG C/ 6 PCS 265 ML,NADIR,Em linha,R05-B14-A00-P01,37224,232,0,36992
51166,67591701426741,"OPALINE ASSADEIRA OVAL 1,4 L",NADIR,Em linha,R05-B09-A00-P02,444,6,144,438
51165,65591701426732,OPALINE ASSADEIRA OVAL 1 L,NADIR,Em linha,R05-B04-A00-P01,174,12,450,162
51164,63591701438549,OPALINE ASSADEIRA OVAL 600 ML,NADIR,Em linha,R05-B07-A00-P01,192,12,324,180
28029,55470200979781,OPALINE STEAK PRATO 26 CM,NADIR,Ponta de Estoque,R06-B24-A00-P02,1632,0,0,1632
28027,57440200847076,"OPALINE PETALA PRATO RASO 25,5 CMS",NADIR,Em linha,R03-B35-A00-P04,2088,1440,11424,648
33248,55490201096032,OPALINE PRATO SATURNO RASO 26 CMS,NADIR,Em linha,R02-B25-A00-P01,4308,252,0,4056
33247,53490201096016,OPALINE PRATO SATURNO SOREMESA 19 CMS,NADIR,Em linha,R04-B03-A00-P01,2928,48,0,2880
22238,42450200923876,"OPALINE SALADEIRA 13 X 5,5    390 ML",NADIR,Em linha,R02-B06-A00-P02,504,72,432,432
22243,58460200923833,OPALINE PRATO PLAZA FUNDO 21 CMS,NADIR,Em linha,R02-B08-A00-P02,1128,0,0,1128
14385,55430200904042,OPALINE MENU PRATO PESO CERTO 27 CMS,NADIR,Em linha,R02-B06-A00-P03,720,72,816,648
40550,55430200848781    ,OPALINE MENU PRATO 27 CMS,NADIR,Em linha,R02-B36-A00-P01,528,312,1632,216
14383,57430200847041,OPALINE MENU PRATO RASO 24 CMS,NADIR,Em linha,R02-B05-A00-P02,456,240,1152,216
14384,58430200847050,OPALINE MENU PRATO FUNDO 23 CMS,NADIR,Em linha,R02-B05-A00-P01,408,360,2160,48
40549,55450200848829    ,OPALINE BLANC PRATO 27 CMS,NADIR,Em linha,R02-B10-A00-P03,216,48,1632,168
22240,58450200922742,OPALINE BLANC PRATO  FUNDO 22 CMS,NADIR,Em linha,R02-B07-A00-P01,960,0,0,960
22239,53450200922700,OPALINE BLANC PRATO  SOBREMESA 19 CMS,NADIR,Em linha,R02-B07-A00-P04,840,48,0,792
55149,18210200984468,DIAMANTE APARELHO DE JANTAR 12PC,NADIR,Em linha,R04-B08-A00-P01,136,0,0,136
8568,58380200511601,DIAMANTE PRATO FUNDO,NADIR,Em linha,R02-B04-A00-P03,246,0,0,246
12413,57380200815293,DIAMANTE PRATO RASO,NADIR,Em linha,R02-B03-A00-P02,600,96,2880,504
12414,58380200814282,DIAMANTE PRATO FUNDO 22 CMS,NADIR,Em linha,R03-B26-A00-P01,40992,3168,102912,37824
45235,58310201001401,"PRIMAVERA JG C/ 6 PRATO FUNDO 22,4 CMS",NADIR,Em linha,R04-B09-A00-P01,696,0,0,696
30843,58310200981339,"PRIMAVERA PRATO FUNDO 22,4 CMS",NADIR,Em linha,R03-B21-A00-P01,24361,4536,35328,19825
11898,58290200779202,ACQUA PRATO FUNDO 22 CMS,NADIR,Em linha,R03-B25-A00-P01,11256,1344,3072,9912
9780,SM400031803N,"MARINEX TIGELA BELLA 25,5 X 9,7  3,1 LTS",NADIR,Em linha,R05-B05-A00-P02,438,18,288,420
9779,SM400031703N,"MARINEX TIGELA BELLA 22,8 X 8,8  2 LTS",NADIR,Em linha,R05-B09-A00-P01,1332,48,0,1284
9778,SM400031503N,"MARINEX TIGELA BELLA 17,4 X 7,1  01 LT",NADIR,Em linha,R06-B22-A01-P01,504,18,1200,486
9764,SM400000800N,"ASTRAL PRATO FUNDO 22,2 CMS",NADIR,Em linha,R06-B13-A00-P01,30072,1728,0,28344
38060,SM400000400N,"ASTRAL PRATO SOPA 19,6 CM",NADIR,Em linha,R01-B02-A00-P02,1152,0,0,1152
9766,SM400011400N,ASTRAL XICARA CHA C/ PIRES,NADIR,Em linha,R04-B10-A00-P01,2568,0,0,2568
9765,SM400011200N,ASTRAL XICARA CAFE C/PIRES,NADIR,Em linha,R04-B06-A01-P01,624,0,1296,624
10517,SM400010400N,ASTRAL XICARA CHA S/PIRES,NADIR,Em linha,R04-B08-A01-P01,2160,72,840,2088
10518,SM400010200N,ASTRAL XICARA CAFE S/PIRES,NADIR,Em linha,R04-B07-A01-P03,1272,48,0,1224
10235,59090200715891,DIVERSOS CANECA ASPEN 300 ML,NADIR,Em linha,R04-B03-A00-P02,2856,2472,2880,384
9768,SM400420200N,"ASTRAL TACA SOBREMESA 10,5 X 5   250 ML",NADIR,Em linha,R04-B10-A01-P01,7944,0,0,7944
3100,104401060,DIVERSOS SALADEIRA PEQUENA 170 ML,NADIR,Em linha,R03-B04-A01-P01,1392,0,7200,1392
8577,61120200803250,"SEMPRE RETANG 29X18,4X6,4   1,8 LTS",NADIR,Em linha,R03-B01-A00-P03,4668,900,3456,3768
8576,65120200802871,"SEMPRE RETANG 36,2X23X6,4   03 LTS",NADIR,Em linha,R03-B01-A00-P02,498,30,600,468
20118,63140200805052,"SEMPRE OVAL 30X18,8X6,1   1,6 LTS",NADIR,Em linha,R01-B01-A00-P01,702,0,0,702
8579,65140200805079,"SEMPRE OVAL 43X34X25    2,5 LTS",NADIR,Em linha,R03-B05-A00-P03,216,24,0,192
11113,68140200803188,"SEMPRE OVAL S/ TPA   39,6X27,6X7,3   04 LTS",NADIR,Em linha,R03-B06-A00-P01,258,0,0,258
9458,61110200802863,SEMPRE QD  16X16X5  730 ML,NADIR,Em linha,R03-B02-A00-P03,996,12,0,984
9459,63110200792773,"SEMPRE QD  20X20X6,3   1,5 LTS",NADIR,Em linha,R03-B05-A00-P01,702,6,330,696
17808,65130200805757,"SEMPRE ASSADEIRA QD  26,4X23,9X7,4  2,4 LTS  ",NADIR,Em linha,R03-B03-A00-P02,486,6,0,480
55155,65190200790858,SEMPRE TIGELA 1 L P/PREPARO,NADIR,Em linha,R02-B02-A00-P01,3732,456,1050,3276
8578,65170200805327,"SEMPRE RED  30,4X27,6X6,1   2,4 LTS",NADIR,Em linha,R03-B04-A00-P02,846,6,0,840
8711,61150200808481,"SEMPRE TERRINA 21X17,2X8,9  01 LT",NADIR,Em linha,R03-B01-A00-P01,336,6,0,330
9461,61120200829100,"SEMPRE RETANG C/TPA  29,5X18,8X6,7   1,8 LTS",NADIR,Em linha,R03-B03-A00-P03,1092,18,0,1074
9460,65120200829089,"SEMPRE RETANG C/TAMPA 3,0 LTS",NADIR,Em linha,R02-B24-A00-P01,1236,24,18,1212
20119,63140200829169,"SEMPRE OVAL C/ TPA  30,4X19,2X6,4  1,57 LTS",NADIR,Em linha,R01-B07-A00-P02,786,0,0,786
17809,65140200829151,"SEMPRE ASSADEIRA OVAL C/ TPA 36X22,8X6,9  2,5 LTS",NADIR,Em linha,R01-B09-A00-P01,138,0,180,138
9462,65170200829126,"SEMPRE RED C/TPA   30,8X27,8X6,4   2,4 LTS",NADIR,Em linha,R03-B04-A00-P01,474,0,0,474
8713,61110200828975,"SEMPRE QUAD C/TPA COLOR  16,6X16,6X5,4  700 ML",NADIR,Em linha,R03-B33-A00-P01,3276,1332,4536,1944
8714,63110200828991,"SEMPRE QUAD C/TPA COLOR  19,9X19,9X6,5   1,5 LTS",NADIR,Em linha,R03-B34-A00-P02,828,36,0,792
9062,65130200829020,"SEMPRE QUAD C/TPA COLOR  27,1X24,1X7,8   2,4 LTS",NADIR,Em linha,R03-B06-A00-P02,840,24,0,816
34108,64190200829193,"SEMPRE TIGELA P/PREPARO C/TPA COLOR 13,8X7 500 ML",NADIR,Em linha,R04-B05-A00-P02,5712,0,0,5712
11111,65190200829214,"SEMPRE TIGELA P/PREPARO C/TPA COLOR 17,3X8,5  1 LT",NADIR,Em linha,R03-B04-A00-P03,234,6,0,228
11556,67190200829185,"SEMPRE TIGELA P/PREPARO C/TPA COLOR 21,5X10  02 LT",NADIR,Em linha,R03-B02-A00-P01,174,0,0,174
6120,GD16229417N,"FORMA FILET. 28,3X25,4X4,7  1,6 LTS",NADIR,Em linha,R07-B18-A00-P01,1860,36,0,1824
5148,GD16228413N,"FORMA FILET. 25,7X22,8X4,7 1,3 LTS",NADIR,Em linha,R06-B23-A00-P01,2076,12,0,2064
7644,GD16538414N,"LASANHEIRA RET FUNDA  40,4X24,9X7    05 LTS",NADIR,Em linha,R07-B20-A00-P01,564,12,0,552
22229,65370200928634,"LASANHEIRA 36,0X22,0X7,0 CM  3,7 LTS",NADIR,Em linha,R05-B10-A00-P03,36,12,360,24
5157,GD16536417N,ASSADEIRA RET GD 394X229X50,NADIR,Em linha,R05-B07-A00-P03,228,12,270,216
5156,GD16534019N,"ASSADEIRA RET MD 34,6X20,9X5,2   2,2 LTS",NADIR,Em linha,R06-B17-A00-P01,780,18,0,762
5155,GD16532011N,"ASSADEIRA RET 29,6X17,8X5  1,6 LTS",NADIR,Em linha,R04-B05-A01-P02,612,0,0,612
5153,GD16495063N,"ASSADEIRA RED 26,3X5,8   2,4 LTS",NADIR,Em linha,R04-B03-A01-P03,390,0,0,390
5159,GD16662010N,"ASSADEIRA OVAL  35X24,2X6,4  3,2 LTS",NADIR,Em linha,R05-B08-A00-P02,624,6,0,618
5150,GD16345016N,"ASSADEIRA OVAL 30,2X21,2X6,3   2,4 LTS",NADIR,Em linha,R04-B06-A01-P02,504,0,0,504
7330,GD16343410N,"ASSADEIRA OVAL 262X181X60  1,6 LTS",NADIR,Em linha,R06-B18-A01-P01,1638,0,0,1638
5160,GD16664419N,"ASSADEIRA OVAL 39,5X27,5X66  04 LTS",NADIR,Em linha,R05-B02-A00-P03,282,0,0,282
5147,GD16222010N,"ASSADEIRA QUAD 24,8X22,1X5,2  1,8 LTS",NADIR,Em linha,R05-B08-A00-P01,408,0,0,408
7329,GD16221418N,"ASSADEIRA QUAD 20,5X18,2X5,0   1,1 LTS",NADIR,Em linha,R05-B04-A00-P03,690,6,0,684
34107,SM400030903N,"ASTRAL TIGELA  29,4 X 10,6  04 LTS",NADIR,Em linha,R05-B05-A00-P03,1224,24,0,1200
9774,SM400030803N,"ASTRAL TIGELA  26,5 X 10  03 LTS",NADIR,Em linha,R04-B10-A01-P02,480,0,0,480
9773,SM400030603N,"ASTRAL TIGELA  20,4 X 9    1,5 LTS",NADIR,Em linha,R04-B04-A01-P01,636,0,0,636
12154,GD16538265N,"LASANHEIRA C/ TAMPA  41,1X25,5X8,4  05 LTS",NADIR,Em linha,R07-B19-A00-P01,744,104,0,640
22228,65360200930283,"COLOR-ASSADEIRA RET C/TPA  39,5X24X5,3  2,9 LTS",NADIR,Em linha,R05-B07-A00-P02,438,12,0,426
8762,GD16534251N,"COLOR-ASSADEIRA RET C/TPA  34,9X21,6X5,4  2,2 LTS",NADIR,Em linha,R05-B04-A00-P02,330,12,0,318
8761,GD16532254N,"COLOR-ASSADEIRA RET C/TPA  30,1X18,4X5,2  1,6 LTS",NADIR,Em linha,R04-B04-A01-P03,366,0,0,366
8760,GD16495257N,"COLOR-ASSADEIRA RED C/TPA  26,3 X 5,8  2,4 LTS  ",NADIR,Em linha,R04-B09-A01-P02,360,18,0,342
8763,GD16662253N,"COLOR-ASSADEIRA OVAL C/TPA 35,7X25X6,7  3,2 LTS",NADIR,Em linha,R05-B08-A00-P03,348,6,0,342
8759,GD16345259N,"COLOR-ASSADEIRA OVAL C/ TPA 30,7X21,6X6,5  2,4 LTS",NADIR,Em linha,R05-B03-A00-P03,360,18,0,342
8758,GD16343251N,"COLOR-ASSADEIRA OVAL C/TPA 26,8X18,8X6,1   1,6 LTS",NADIR,Em linha,R04-B05-A01-P01,402,12,0,390
12369,GD16457712N,"TERRINA RED C/ TPA 28,5X22,5X8,2 CM 2800 ML ",NADIR,Em linha,R04-B08-A01-P02,276,3,0,273
8756,GD16222253N,"COLOR-ASSADEIRA QUAD C/TP 25,2X22,6X5,4  1,8 LTS",NADIR,Em linha,R05-B05-A00-P01,180,6,0,174
8755,GD16221250N,"COLOR-ASSADEIRA QUAD C/TPA 21,2X18,8X5,2  1,1 LTS",NADIR,Em linha,R04-B05-A01-P03,504,0,0,504
9777,SM400030833N,"ASTRAL TIGELA C/ TAMPA COL 27 X 10,2  03 LTS",NADIR,Em linha,R06-B20-A00-P01,738,84,0,654
9776,SM400030633N,"ASTRAL TIGELA C/ TAMPA COL 21 X 9,4  1,5 LTS",NADIR,Em linha,R07-B14-A00-P01,798,492,1530,306
9775,SM400030337N,"ASTRAL TIGELA C/ TAMPA COL 15,5 X 6    500 ML",NADIR,Em linha,R06-B21-A01-P01,2172,60,0,2112
35584,65390201016215,"SELETTA ASSADEIRA C/TPA RET  37,1X23,2X8  3,5 LTS",NADIR,Em linha,R04-B06-A01-P03,140,0,0,140
25994,65390200962509,"SELETTA ASSADEIRA RET 37,1X22,9X6,9   3,5 LTS",NADIR,Em linha,R05-B06-A00-P02,252,0,0,252
25995,65350200962496,"SELETTA ASSADEIRA RET 34,8X19,8X6,9   2,7 LTS",NADIR,Em linha,R05-B06-A00-P01,348,0,0,348
31444,63390201015731,"SELETTA ASSADEIRA RET  32,6X17,6X7  2,1 LTS",NADIR,Em linha,R05-B06-A00-P03,54,0,156,54
12962,GD16726019N,"PRATICA TIGELA REDONDA C/TPA  22,3X11,5  2,4 LTS",NADIR,Em linha,R05-B10-A00-P02,144,0,0,144
12961,GD16313015N,"PRATICA TIGELA REDONDA C/TPA  17,8 X 8,2   1,2 LTS",NADIR,Em linha,R04-B03-A01-P02,996,0,0,996
12960,GD16312011N,"PRATICA TIGELA REDONDA C/TPA  14,4 X 6,3   600 ML",NADIR,Em linha,R04-B09-A01-P03,36,0,240,36
12995,GD16216010N,"PRATICA FORMA RET.P/BOLO C/TPA 28X14,8X7,2 1,5 LTS",NADIR,Ponta de Estoque,R06-B32-A00-P01,84,12,0,72
12994,GD16214013N,"PRATICA FORMA RETANG C/TPA 17,8X11,5X6,8 CM 700 ML",NADIR,Em linha,R05-B01-A01-P02,120,0,240,120
5152,GD16487017N,"FORMA P/BRIOCHE 21,6 X 8   1,3 LTS ",NADIR,Em linha,R04-B10-A01-P03,756,0,0,756
55931,GD16538931N,CELEBRITY - LASANHEIRA RET FUNDA 5L - 40X25X7 CM,NADIR,Em linha,R04-B10-A00-P02,388,8,300,380
55934,GD16536934N,"CELEBRITY - ASSADEIRA RET GD 39,4X23,9X5,1 CM",NADIR,Em linha,R05-B01-A00-P03,526,0,0,526
55933,GD16664936N,"CELEBRITY - ASSADEIRA OVAL 4L- 39,5X27,5X66 CM",NADIR,Em linha,R05-B01-A00-P02,403,6,0,397
55932,GD16662939N,"CELEBRITY - ASSADEIRA OVAL 3,2L - 35,2X24,4X6,6 CM",NADIR,Em linha,R05-B03-A00-P02,371,2,0,369
12374,SM400072703N,"FACILITA-VAP 20,2X20,2X9,8   02 LTS",NADIR,Em linha,R07-B16-A00-P01,750,174,1782,576
12372,SM400072503N,"FACILITA-VAP 16,4X16,4X8,3   01 LT",NADIR,Em linha,R07-B13-A00-P01,2160,210,1380,1950
12371,SM400072307N,"FACILITA-VAP 13,7X13,7X6,8   500 ML",NADIR,Em linha,R07-B15-A01-P01,3780,1128,6048,2652
12373,SM400072103N,"FACILITA-VAP ALTA  13,7X13,7X12  01 LT",NADIR,Em linha,R04-B07-A01-P02,420,0,0,420
20117,SM400072676N,FACILITA-VAP RET   20X15X5   750 ML ,NADIR,Em linha,R07-B17-A00-P01,210,72,990,138
12370,SM400072900N,"FACILITA-VAP  11,5X11,5X5,5   300 ML",NADIR,Em linha,R04-B09-A01-P01,1248,96,864,1152
38166,PUD005018,CRYSTAL - CJ SOBREMESA 7 PC 34 X 25 X 8CM,WHEATON,Em linha,R05-B02-A01-P03,156,0,0,156
14053,PUD002642,CRYSTAL - AP DE JANTAR 16 PC C/COPO 47X24X32 CM,WHEATON,Em linha,R06-B08-A00-P02,354,0,0,354
14054,PUD002330,CRYSTAL - AP DE JANTAR 20 PC 47 X 33 CM,WHEATON,Em linha,R06-B08-A00-P01,88,0,0,88
10877,PUD000278,CRYSTAL - CJ PRATO FUNDO C/ 06 PC 22X22X12 CM,WHEATON,Em linha,R12-B17-A00-P01,1968,288,2220,1680
10876,PUD000275,"CRYSTAL - CJ PRATO RASO C/ 06 PC 23,4X22,5X23 CM",WHEATON,Em linha,R06-B08-A00-P03,90,0,60,90
11002,PUD001037,"CRYSTAL - PRATO BOLO 28,5 CM",WHEATON,Em linha,R14-B14-A00-P01,528,72,4080,456
10854,PUD002738,CRYSTAL - PRATO RASO 23 CMS,WHEATON,Em linha,R06-B07-A00-P01,2808,36,0,2772
10855,PUD002739,CRYSTAL - PRATO FUNDO 22 CM,WHEATON,Em linha,R12-B13-A00-P01,6444,252,1800,6192
16292,PUD000310,"CRYSTAL - TIGELINHA 10,6 CMS",WHEATON,Em linha,R05-B06-A01-P03,624,0,960,624
10881,PUD002135,CRYSTAL - XICARA CAFE C/ PIRES 06 PCS,WHEATON,Em linha,R05-B03-A01-P02,1410,72,0,1338
34048,PUD002149,CRYSTAL - XICARA DE CAFE C/ PIRES,WHEATON,Em linha,R05-B08-A01-P03,1944,168,720,1776
10863,PUD002960,CRYSTAL - XICARA CAFE S/ PIRES,WHEATON,Em linha,R15-B18-A00-P01,21696,720,0,20976
11001,PUD000316,CRYSTAL - TIGELA GRANDE 22 CM,WHEATON,Em linha,R12-B14-A00-P01,1272,1104,13680,168
10880,PUD000360,"CRYSTAL - XICARA CHA C/ PIRES 06 PC 15,5X10,5X55CM",WHEATON,Em linha,R14-B13-A00-P01,834,120,300,714
34047,PUD001045,CRYSTAL - XICARA DE CHA C/ PIRES,WHEATON,Em linha,R14-B18-A00-P01,4608,1488,9120,3120
10862,PUD002959,CRYSTAL - XICARA CHA S/ PIRES,WHEATON,Em linha,R13-B15-A00-P01,22872,3024,26400,19848
40426,PUD005027,CRYSTAL - XICARA CHA SEM PIRES  AMBAR,WHEATON,Em linha,R15-B13-A00-P01,19248,2952,31200,16296
18793,PUD000600,CRYSTAL - JG TACA P/ SOBREMESA 06 PCS  370 ML,WHEATON,Em linha,R14-B16-A00-P01,4140,1484,6680,2656
38171,PUD004922,CRYSTAL - TACA SOBREMESA 370 ML,WHEATON,Em linha,R05-B07-A01-P03,396,12,1800,384
14050,PUD000011,CANECA FRITZ 475 ML,WHEATON,Em linha,R05-B10-A01-P01,10927,3396,26400,7531
10879,PUD000748,CRYSTAL - JG COPO 310 ML C/ 06 PCS,WHEATON,Em linha,R13-B20-A00-P01,4392,894,6900,3498
38167,PUD000469,CRYSTAL - COPO MULTIUSO 310ML,WHEATON,Em linha,R05-B09-A01-P03,21840,96,0,21744
38168,PUD000029,BRASIL - COPO ITAPEMA MULTIUSO 310 ML,WHEATON,Em linha,R06-B10-A01-P01,3072,192,1440,2880
32557,PUD004803,BAVIERA MINI - COPO P/ CHOPP 200 ML,WHEATON,Em linha,R05-B08-A01-P02,10656,3960,9600,6696
10873,PUD000026,BRASIL - JG COPO OURO PRETO 310 ML,WHEATON,Em linha,R13-B17-A00-P01,5838,918,6600,4920
10871,PUD000003,BRASIL - JG COPO BAHIA 310 ML,WHEATON,Em linha,R13-B16-A00-P01,5310,984,6000,4326
23335,PUD000034,BRASIL - JG COPO RIO DE JANEIRO 310 ML,WHEATON,Em linha,R13-B19-A00-P01,7500,966,4200,6534
26865,PUD000736,CONFETTI - PRATO RASO VERMELHO 27 CMS,WHEATON,Em linha,R06-B09-A00-P03,636,36,0,600
19702,PUD000131,CONFETTI - PRATO RASO PRETO 27 CM,WHEATON,Em linha,R06-B10-A00-P01,480,0,0,480
26283,PUD000130,CONFETTI - PRATO RASO BRANCO 27 CMS,WHEATON,Em linha,R06-B10-A00-P02,624,0,0,624
26866,PUD000743,CONFETTI - PRATO FUNDO VERMELHO 23 CM,WHEATON,Em linha,R06-B08-A01-P01,924,12,0,912
19703,PUD000143,CONFETTI - PRATO FUNDO PRETO 23 CM,WHEATON,Em linha,R05-B06-A01-P03,624,0,0,624
26282,PUD000142,CONFETTI - PRATO FUNDO BRANCO 23 CMS,WHEATON,Em linha,R06-B09-A01-P01,516,0,0,516
23329,PUD000740,BARROCO - CJ SOBREMESA 07 PCS 48X43X32 CM,WHEATON,Em linha,R05-B03-A01-P03,118,4,120,114
27874,PUD001052,BARROCO - CJ TACA P/ SOBREMESA 6 PCS 40X21X30CM,WHEATON,Em linha,R05-B05-A01-P03,84,20,160,64
56286,PUD005220,BARROCO - TACA P/ SOBREMESA 370 ML AMBAR,WHEATON,Em linha,R15-B14-A00-P01,3492,12,360,3480
10668,PUD003647,BARROCO - CJ MINI BAR 18 PCS 56 X 38 CM,WHEATON,Em linha,R06-B08-A01-P02,67,0,40,67
40433,PUD003944,BARROCO - TACA AGUA C/ 06   250 ML,WHEATON,Em linha,R05-B09-A01-P02,2760,318,1320,2442
22190,PUD003911,BARROCO - TACA MULTIUSO BRANCO 250 ML,WHEATON,Em linha,R12-B18-A00-P01,18096,1584,21600,16512
56285,PUD005217,BARROCO - TAÇA AGUA 250 ML AMBAR,WHEATON,Em linha,R15-B15-A00-P01,13944,144,6000,13800
40432,PUD003373,BARROCO -  CJ COPO APERITIVO C/ 04 120 ML,WHEATON,Em linha,R05-B03-A01-P01,22032,24,0,22008
11009,PUD003372,BARROCO - COPO APERITIVO 120 ML,WHEATON,Em linha,R15-B17-A00-P01,7392,480,2400,6912
11345,PUD003530,BARROCO - TACA P/ VINHO 190 ML,WHEATON,Em linha,R12-B19-A00-P01,15576,1224,14400,14352
56284,PUD005218,BARROCO - TAÇA VINHO 190 ML AMBAR,WHEATON,Em linha,R15-B16-A00-P01,26280,72,2400,26208
9524,PUD003151,BARROCO - CANEQUINHA C/ 04 PCS,WHEATON,Em linha,R05-B06-A01-P01,1848,108,240,1740
10864,PUD002963,BARROCO - CANEQUINHA MULTIUSO 80 ML,WHEATON,Em linha,R14-B17-A00-P01,12192,672,5760,11520
56299,PUD005222,BARROCO - CANEQUINHA MULTIUSO 80 ML AMBAR,WHEATON,Em linha,R05-B02-A01-P02,20784,480,0,20304
10875,PUD002407,BARROCO - JG COPO MULTIUSO 310 ML C/ 06 PCS,WHEATON,Em linha,R13-B21-A00-P01,4242,1284,12000,2958
23325,PUD002448,BARROCO - COPO MULTIUSO 310 ML,WHEATON,Em linha,R06-B09-A01-P02,10944,288,0,10656
40424,PUD005029,BARROCO - COPO AGUA 310 ML AMBAR,WHEATON,Em linha,R05-B10-A01-P04,39360,144,0,39216
11005,PUD002449,BARROCO - COPO ON THE ROCKS 300 ML,WHEATON,Em linha,R06-B07-A00-P02,1680,0,0,1680
23331,PUD002443,BARROCO - TIGELA GRANDE 22 CM,WHEATON,Em linha,R13-B14-A00-P01,1272,1176,13680,96
16290,PUD002444,BARROCO - TIGELA P/ CEREAIS 19 CMS,WHEATON,Em linha,R05-B04-A01-P04,1872,24,0,1848
23330,PUD000156,"BARROCO - TIGELINHA 11,43 CM",WHEATON,Em linha,R05-B01-A01-P01,1632,96,0,1536
40434,PUD003674,"BARROCO - PRATO MULTIUSO Ø 28,5 CM",WHEATON,Em linha,R06-B09-A00-P02,900,36,0,864
16288,PUD003671,"BARROCO - PRATO RASO 22,8 CMS  ",WHEATON,Em linha,R06-B10-A01-P02,1272,0,0,1272
10858,PUD003672,BARROCO - PRATO FUNDO 22 CMS   ,WHEATON,Em linha,R05-B07-A01-P01,1284,0,0,1284
23332,PUD000042,"EMOTIONS - CJ SOBREMESA 7 PC 24;8X8X34,2 CM",WHEATON,Em linha,R06-B08-A01-P03,70,2,40,68
34041,PUD004899,EMOTIONS - PRATO RASO 25 CMS,WHEATON,Em linha,R05-B04-A01-P01,456,24,0,432
34040,PUD004901,EMOTIONS - PRATO FUNDO 24 CM,WHEATON,Em linha,R05-B04-A01-P03,720,0,0,720
10869,PUD002964 ,EMOTIONS - TACA MULTIUSO VERAO C/ 06 PCS 220 ML,WHEATON,Em linha,R05-B09-A01-P03,264,0,180,264
38169,PUD004920,EMOTIONS - TACA P/ AGUA 225 ML,WHEATON,Em linha,R05-B02-A01-P01,8545,0,1920,8545
23334,PUD000046,EMOTIONS - TIGELA GRANDE 22 CM,WHEATON,Em linha,R05-B08-A01-P01,432,12,480,420
23333,PUD000045,"EMOTIONS - TIGELINHA 11,98 CM",WHEATON,Em linha,R05-B05-A01-P02,432,0,240,432
22226,PUD000716,CJ TACA CAPPUCCINO COFFEE 115 ML  C/ 04 PCS ,WHEATON,Em linha,R05-B09-A01-P01,296,0,0,296
9514,PUD001039,CANECA CAFE CAPUCCINO 115 ML,WHEATON,Em linha,R06-B07-A01-P02,3216,144,0,3072
56288,PUD005221,CANECA CAFE CAPUCCINO 115 ML AMBAR,WHEATON,Em linha,R05-B05-A01-P01,3386,0,0,3386
11008,PUD003595,PORTA MANTIM OITAVADO 298 ML,WHEATON,Em linha,R05-B01-A01-P02,3312,72,0,3240
11007,PUD002912,PORTA MANTIM SEXTAVADO 150 ML,WHEATON,Em linha,R06-B07-A01-P01,5016,216,0,4800
57207,24180598,COPO ATLANTA 450 ML AVULSO FUNNY,RUVOLO,Lancamento,R06-B04-A01-P02,72,0,360,72
56699,750180598,COPO ATLANTA 450 ML CX C/ 01 FUNNY,RUVOLO,Em linha,R06-B02-A01-P02,423,9,0,414
56700,260180598,COPO ATLANTA 450 ML LV C/ 02 FUNNY,RUVOLO,Em linha,R06-B01-A00-P01,204,0,0,204
57203,24780586,TAÇA BEER MASTER 380 ML AVULSO FUNNY,RUVOLO,Lancamento,R06-B03-A01-P02,576,24,0,552
56689,750180586,TAÇA BEER MASTER 380 ML CX C/ 01 PC FUNNY,RUVOLO,Em linha,R06-B03-A00-P03,472,21,0,451
56690,260180586,TAÇA BEER MASTER 380 ML LV C/ 02 PC FUNNY,RUVOLO,Em linha,R06-B03-A00-P01,193,0,0,193
57201,24780719,TAÇA BARCELONA 370 ML AVULSO HAPPY HOUR ,RUVOLO,Lancamento,R06-B03-A01-P03,432,24,0,408
56693,750180719,TAÇA BARCELONA 370 ML CX C/ 01 PC HAPPY HOUR ,RUVOLO,Em linha,R06-B04-A00-P01,409,16,120,393
56694,260180719,TAÇA BARCELONA 370 ML LV C/ 02 PC HAPPY HOUR ,RUVOLO,Em linha,R06-B01-A01-P01,195,2,0,193
57205,24780585,TAÇA ROYAL BEER 330 ML AVULSO FUNNY,RUVOLO,Lancamento,R06-B04-A01-P03,600,0,0,600
56691,750180585,TAÇA ROYAL BEER 330 ML CX C/ 01 PC FUNNY,RUVOLO,Em linha,R06-B02-A01-P03,360,10,240,350
56692,260180585,TAÇA ROYAL BEER 330 ML LV C/ 02 PC FUNNY,RUVOLO,Em linha,R06-B01-A01-P02,176,2,0,174
57209,24680597,TAÇA BLUMENAU 300 ML AVULSO HAPPY HOUR ,RUVOLO,Lancamento,R06-B05-A01-P01,288,0,0,288
56685,660180597,TAÇA BLUMENAU 300 ML CX C/ 01 PC HAPPY HOUR ,RUVOLO,Em linha,R06-B01-A01-P03,493,6,0,487
56686,2680597,TAÇA BLUMENAU 300 ML LV C/ 02 PC HAPPY HOUR ,RUVOLO,Em linha,R06-B02-A00-P01,157,2,0,155
57204,24780597,TAÇA BLUMENAU 300 ML AVULSO FUNNY DEC1,RUVOLO,Lancamento,R06-B03-A01-P04,312,0,168,312
56687,610180597,TAÇA BLUMENAU 300 ML CX C/ 01 PC FUNNY DEC1,RUVOLO,Em linha,R07-B02-A01-P01,421,9,0,412
56688,260597,TAÇA BLUMENAU 300 ML LV C/ 02 PC FUNNY DEC1,RUVOLO,Em linha,R06-B03-A00-P02,178,2,0,176
56695,750180597,TAÇA BLUMENAU 300 ML CX C/ 01 PC FUNNY DEC2,RUVOLO,Em linha,R06-B06-A00-P02,230,11,360,219
56696,260180597,TAÇA BLUMENAU 300 ML LV C/ 02 PC FUNNY DEC2,RUVOLO,Em linha,R06-B03-A01-P01,158,0,0,158
57206,24780595,TAÇA BERLIM 330 ML AVULSO FUNNY,RUVOLO,Lancamento,R06-B04-A01-P01,600,0,0,600
56697,750180595,TAÇA BERLIM 330 ML CX C/ 01 PC FUNNY,RUVOLO,Em linha,R06-B02-A01-P01,283,11,240,272
56698,260180595,TAÇA BERLIM 330 ML LV C/ 02 PC FUNNY,RUVOLO,Em linha,R06-B06-A00-P01,77,0,0,77
57200,80599101,TAÇA GIN 705 ML HASTE VERDE AVULSO,RUVOLO,Lancamento,R06-B06-A01-P01,456,12,0,444
56701,1210599,TAÇA GIN 705 ML HASTE VERDE CX C/ 01 PC,RUVOLO,Em linha,R07-B01-A01-P01,349,0,0,349
56702,610599,TAÇA GIN 705 ML HASTE VERDE LV C/ 02 PC,RUVOLO,Em linha,R06-B05-A00-P01,92,0,0,92
57202,80599401,TAÇA GIN 705 ML HASTE LARANJA AVULSO,RUVOLO,Lancamento,R06-B05-A01-P03,252,0,204,252
56707,1240599,TAÇA GIN 705 ML HASTE LARANJA CX C/ 01 PC,RUVOLO,Em linha,R07-B02-A01-P02,421,0,0,421
56708,640599,TAÇA GIN 705 ML HASTE LARANJA LV C/ 02 PC,RUVOLO,Em linha,R06-B02-A00-P02,141,0,0,141
57199,80599301,TAÇA GIN 705 ML HASTE AZUL AVULSO,RUVOLO,Lancamento,R06-B06-A01-P03,444,12,0,432
56705,1230599,TAÇA GIN 705 ML HASTE AZUL CX C/ 01 PC,RUVOLO,Em linha,R07-B01-A01-P03,533,2,0,531
56706,630599,TAÇA GIN 705 ML HASTE AZUL LV C/ 02 PC,RUVOLO,Em linha,R06-B01-A00-P02,149,0,0,149
57198,80599201,TAÇA GIN 705 ML HASTE VERMELHA AVULSO,RUVOLO,Lancamento,R06-B06-A01-P02,456,36,0,420
56703,1220599,TAÇA GIN 705 ML HASTE VERMELHA CX C/ 01 PC,RUVOLO,Em linha,R07-B01-A01-P02,239,2,0,237
56704,620599,TAÇA GIN 705 ML HASTE VERMELHA LV C/ 02 PC,RUVOLO,Em linha,R06-B05-A00-P02,134,1,0,133
51127,1760,CJ BOLEIRA BICO DE JACA Ø28 X 16 CM CX LITOGRAF,VITAZZA,Em linha,R07-B03-A00-P01,280,24,140,256
51125,1740,CJ BOLEIRA Ø28 X 16 CM CX LITOGRAF,VITAZZA,Em linha,R08-B10-A00-P01,466,24,0,442
46912,1780,CJ BOLEIRA LUMARE Ø34 X 20 CM,VITAZZA,Em linha,R07-B04-A01-P02,186,10,100,176
51128,1770,CJ BOLEIRA BICO DE JACA Ø28 X 25 CM C/PÉ CX LITOGR,VITAZZA,Em linha,R07-B04-A00-P01,559,36,40,523
51126,1750,CJ BOLEIRA Ø28 X 25 CM C/PÉ CX LITOGRAF,VITAZZA,Em linha,R08-B09-A00-P01,311,40,420,271
46913,1790,CJ BOLEIRA LUMARE C/ PE Ø34 X 25 CM,VITAZZA,Em linha,R07-B09-A01-P01,265,10,109,255
15047,1820,"CJ BOLEIRA PETIT POA  Ø28 X 14,5 CM",VITAZZA,Em linha,R07-B08-A01-P03,281,23,140,258
34109,1800,CJ BOLEIRA LÍRIO Ø32 X 17 CM,VITAZZA,Em linha,R07-B09-A01-P03,277,8,0,269
20241,2900,QUEIJEIRA PETIT POA - Ø18 X 16  CM,VITAZZA,Em linha,R07-B10-A00-P01,1156,52,0,1104
26963,1830,"CJ BOLEIRA PETIT POA C/ PE Ø28 X 22,5 CM",VITAZZA,Em linha,R07-B08-A01-P01,560,25,0,535
34110,1810,CJ BOLEIRA LÍRIO C/PE Ø32 X 24 CM,VITAZZA,Em linha,R07-B10-A01-P01,641,21,0,620
35618,2910,QUEIJEIRA PETIT POA C/ PE   Ø21 X 23 CM,VITAZZA,Em linha,R07-B05-A01-P01,416,12,80,404
34129,3140,TIGELA ROUND 3 L -Ø26 X 10 CM,VITAZZA,Em linha,R07-B05-A00-P02,1626,6,0,1620
34126,3150,TIGELA ROUND 3 L C/ TPA PLÁSTICA - Ø26 X 10 CM  ,VITAZZA,Em linha,R18-B13-A00-P01,698,60,0,638
51136,3170,"TIGELA ROUND 2,2 L C/TAMPA PLÁSTICA Ø21 X 11 CM",VITAZZA,Em linha,R07-B02-A00-P01,1794,120,120,1674
51140,3210,TIGELA ROUND 3L ESPIRAL Ø26 X 10 CM,VITAZZA,Em linha,R07-B09-A00-P02,1194,12,0,1182
48575,3200,TIGELA ROUND 3 L ESPIRAL C/ TPA PLÁSTICA Ø26 X 10 CM,VITAZZA,Em linha,R07-B07-A00-P02,710,12,0,698
51130,2300,"TIGELA VENEZZA 1,5 L ESPIRAL C/ TPA PLASTICA  Ø20 X 10 CM",VITAZZA,Em linha,R07-B08-A00-P01,2719,12,0,2707
55935,2250,TIGELA VENEZZA 3 L ESPIRAL C/ TPA PLASTICA  Ø26 X 11 CM ,VITAZZA,Em linha,R07-B06-A00-P02,814,12,0,802
51129,2290,"TIGELA VENEZZA 2,2 L C/TPA PLÁSTICA  Ø20 X 12 CM",VITAZZA,Em linha,R07-B01-A00-P01,1092,36,744,1056
42126,2230,"TIGELA VENEZZA 2,6 L C/ TPA Ø26 X 10 CM",VITAZZA,Em linha,R19-B13-A00-P01,3133,6,0,3127
51123,1280,"TIGELA OCEANI 3,8 L C/ TPA PLÁSTICA  Ø27 X 09 CM",VITAZZA,Em linha,R19-B14-A00-P01,2466,84,0,2382
39688,2210,"TIGELA LÍRIO 2,3 L C/TPA Ø26 X 11 CM",VITAZZA,Em linha,R18-B14-A00-P01,1482,24,0,1458
51135,3090,TIGELA LAGUNA 4 L C/TPA PLÁSTICA  Ø27 X 10 CM,VITAZZA,Em linha,R08-B08-A00-P02,693,108,120,585
39689,3100,"TIGELA LAGUNA 1,5 L C/ TPA PLÁSTICA Ø20 X 9 CM",VITAZZA,Em linha,R19-B15-A00-P01,1392,66,330,1326
38313,3110,TIGELA LAGUNA 750 ML C/TPA PLÁSTICA Ø16 X 7 CM,VITAZZA,Em linha,R07-B07-A00-P04,5316,48,0,5268
39733,1000,"ASSADEIRA ROUND C/ TPA 2,4 L - Ø26 X 6 CM",VITAZZA,Em linha,R07-B09-A00-P01,486,18,0,468
52803,1010,"ASSADEIRA ROUND COM ABA 2,4L - Ø30,5 X 6 CM",VITAZZA,Em linha,R08-B07-A00-P02,289,6,240,283
52802,1200,"ASSADEIRA ROUND COM ABA 2,3L - Ø22,5 X 9 CM",VITAZZA,Em linha,R07-B05-A00-P01,528,6,0,522
51132,2690,PRATO LUMARE - Ø34 X 11 CM C/PÉ,VITAZZA,Em linha,R07-B04-A01-P01,328,17,60,311
46914,2700,"PRATO LUMARE - Ø34 X 1,5 CM",VITAZZA,Em linha,R07-B07-A01-P01,119,0,210,119
42125,2200,CENTRO DE MESA CALIFORNIA 2 L - Ø26 X 8 CM,VITAZZA,Em linha,R07-B07-A00-P01,624,48,1200,576
51138,3530,"POTICHE BICO DE JACA 4,5 L C/ TPA PLÁSTICA  Ø27 X 13 CM",VITAZZA,Em linha,R07-B05-A00-P03,1530,12,0,1518
51137,3560,POTICHE BICO DE JACA 6 L C/ TPA DE VIDRO  Ø26 X 22 CM,VITAZZA,Em linha,R07-B08-A00-P03,353,22,300,331
52800,7000,VASO DEC GREEN VITTA  Ø13 X 13 CM,VITAZZA,Em linha,R07-B07-A01-P02,630,6,0,624
56656,1440,CENTRO DE MESA LUMINA C/ PE  Ø38 X 15CM,VITAZZA,Em linha,R07-B03-A01-P03,104,11,90,93
56657,1440T-AB,CENTRO DE MESA LUMINA C/ PE  Ø38 X 15CM AMBAR,VITAZZA,Em linha,R07-B03-A01-P01,350,31,0,319
56658,1436T-AB,CENTRO DE MESA LUMINA  Ø38 X 5CM AMBAR,VITAZZA,Em linha,R07-B06-A01-P01,229,24,60,205
56653,1460,CENTRO DE MESA PLUMA C/ PE  Ø38 X 15CM,VITAZZA,Em linha,R07-B05-A01-P02,267,20,60,247
56654,1460T-VM,CENTRO DE MESA PLUMA C/ PE  Ø38 X 15CM VERMELHO,VITAZZA,Em linha,R07-B03-A01-P02,295,41,240,254
56655,1456T-VM,CENTRO DE MESA PLUMA  Ø38 X 5CM VERMELHO,VITAZZA,Em linha,R08-B08-A00-P01,415,6,0,409
31525,1340,CENTRO DE MESA FLÓRIDA C/ PE  Ø39 X 16CM,VITAZZA,Em linha,R07-B06-A01-P02,466,26,0,440
26967,1336,CENTRO DE MESA FLÓRIDA Ø39 X 9 CM,VITAZZA,Em linha,R07-B09-A00-P03,530,12,0,518
31526,1310,CENTRO DE MESA ESPIRAL C/ PE  Ø38 X 18 CM,VITAZZA,Em linha,R07-B04-A01-P03,90,18,20,72
26966,1306,CENTRO DE MESA ESPIRAL Ø38 X 11 CM,VITAZZA,Em linha,R07-B06-A00-P01,366,12,0,354
51124,1320,CENTRO DE MESA ESPIRAL 30 CM,VITAZZA,Em linha,R08-B07-A00-P01,343,0,0,343
55522,10323,VASO PAGODE - Ø14 X 7 CM,IMPERIAL,Em linha,R09-B09-A01-P02,1875,24,0,1851
56134,10337,VASO SATURNO - Ø12 X 8 CM,IMPERIAL,Em linha,R09-B06-A01-P01,432,0,0,432
55517,10346,VASO EQUEBANA - Ø11 X 9 CM,IMPERIAL,Em linha,R08-B01-A01-P02,408,0,600,408
55511,10353,TAÇA CANCUN C/COLAR - Ø13 X 14 CM,IMPERIAL,Em linha,R21-B15-A00-P01,625,72,0,553
56117,10319,VASO CHINES P - Ø9 X 11 CM,IMPERIAL,Em linha,R08-B04-A01-P02,432,0,480,432
56116,10320,"VASO CHINES M - Ø9,5 X 12 CM",IMPERIAL,Em linha,R21-B14-A00-P01,457,0,0,457
55542,10333,"VASO PÊRA P - Ø5,5 X 10 CM",IMPERIAL,Em linha,R09-B05-A01-P02,600,0,0,600
56133,10334,VASO PÊRA G - Ø9 X 18 CM,IMPERIAL,Em linha,R08-B02-A01-P02,793,24,0,769
56130,10325,TACA TULIPA - Ø11 X 18 CM,IMPERIAL,Em linha,R09-B10-A01-P01,603,24,0,579
56120,10345,VASO DONZELA - Ø10 X 19 CM,IMPERIAL,Em linha,R08-B03-A01-P01,571,0,0,571
55515,10327,COPO VELA 8X18 - Ø8 X 18 CM,IMPERIAL,Em linha,R09-B03-A01-P03,889,24,0,865
55516,10328,COPO VELA 9X22 - Ø9 X 22 CM,IMPERIAL,Em linha,R09-B06-A01-P02,1036,24,0,1012
56119,10331,COPO BALI - Ø6 X 25 CM,IMPERIAL,Em linha,R08-B05-A01-P02,793,48,0,745
55545,10365,VASO VALÊNCIA - Ø9 X 20 CM,IMPERIAL,Em linha,R08-B10-A01-P01,913,72,600,841
55524,10507,"SOLITÁRIO ROMA - Ø5,5 X 22,5 CM",IMPERIAL,Em linha,R09-B02-A01-P02,703,48,600,655
55523,10513,"SOLITÁRIO ALADIM - Ø4,5 X 24 CM",IMPERIAL,Em linha,R09-B02-A00-P02,878,180,900,698
56272,50921,"GARRAFA ROMANA MED. 900 ML - Ø6,5 X 22 CM",IMPERIAL,Em linha,R09-B04-A01-P02,744,24,0,720
56131,10587,"VASO BAHAMAS - Ø19,5 X 24 CM",IMPERIAL,Em linha,R08-B03-A00-P02,447,24,0,423
56132,10609,VASO IBIZA - Ø12 X 24 CM,IMPERIAL,Em linha,R08-B08-A01-P01,120,12,60,108
55538,10584,"VASO AZALÉIA - Ø12 X 27,5 CM",IMPERIAL,Em linha,R08-B06-A01-P01,216,12,0,204
55540,10645,VASO JULIETA - Ø13 X 29 CM,IMPERIAL,Em linha,R08-B05-A01-P01,373,0,120,373
55543,10643,"VASO ROMEU - Ø9,5 X 29 CM",IMPERIAL,Em linha,R08-B01-A01-P01,234,0,240,234
55537,10516,TUBO - Ø10 X 30 CM,IMPERIAL,Em linha,R09-B10-A01-P02,476,60,180,416
56125,10512,SOLITARIO NAPOLITANO - Ø22 X 33 CM,IMPERIAL,Em linha,R08-B06-A01-P02,206,12,480,194
56135,10660,VASO VENEZA - Ø9 X 35 CM,IMPERIAL,Em linha,R08-B07-A01-P02,204,0,0,204
55544,10654,VASO TORINO - Ø15 X 36 CM,IMPERIAL,Em linha,R09-B07-A01-P02,473,12,0,461
55539,10612,"VASO ITÁLIA - Ø18,5 X 34 CM",IMPERIAL,Em linha,R08-B07-A01-P01,429,12,0,417
56136,10827,VASO VISEU - Ø18 X 35 CM,IMPERIAL,Em linha,R09-B08-A01-P02,190,6,0,184
56127,10464,"TACA MALAGA P/DECORACAO - Ø16,5 X 35 CM",IMPERIAL,Em linha,R08-B08-A01-P02,372,6,0,366
56138,10408,CASTIÇAL NÁPOLI - Ø7 X 25 CM,IMPERIAL,Em linha,R08-B05-A01-P03,432,12,0,420
55534,10409,"TAÇA NAPOLI PEQ. - Ø13,5 X 34 CM",IMPERIAL,Em linha,R09-B05-A01-P01,376,6,0,370
55533,10410,"TAÇA NAPOLI MÉD. - Ø14,5 X 41 CM",IMPERIAL,Em linha,R09-B08-A01-P01,175,6,0,169
55541,10635,"VASO ORIENTAL - Ø10,5 X 55,5 CM",IMPERIAL,Em linha,R09-B06-A00-P01,404,12,180,392
55535,10442,TAÇA VERSALHES GDE. PÉ BX. - Ø28 X 21 CM,IMPERIAL,Em linha,R09-B03-A00-P01,316,12,0,304
55536,10438,"TAÇA VERSALHES MÉD. PÉ BX. - Ø20,5 X 20,5 CM",IMPERIAL,Em linha,R08-B09-A01-P01,469,0,0,469
56128,10444,"TACA VERSALHES GDE. PÉ BX. ESP.  - Ø28 X 23,5 CM",IMPERIAL,Em linha,R09-B04-A00-P01,144,0,0,144
56129,10440,TACA VERSALHES MED. PÉ BX. ESP. - Ø20 X 20 CM,IMPERIAL,Em linha,R08-B04-A00-P01,145,0,0,145
56121,10301,AQUÁRIO PP - Ø6 X 8 CM,IMPERIAL,Em linha,R08-B10-A01-P03,1682,0,120,1682
55501,10303,"AQUÁRIO P - Ø8,8 X 9,5 CM",IMPERIAL,Em linha,R09-B07-A01-P01,2697,144,240,2553
55500,10305,"AQUÁRIO M - Ø11,5 X 14 CM",IMPERIAL,Em linha,R21-B13-A00-P01,2899,216,480,2683
55498,10307,"AQUÁRIO G - Ø15 X 17,8 CM",IMPERIAL,Em linha,R20-B13-A00-P01,640,96,276,544
55499,10309,AQUÁRIO GG - Ø18 X 22 CM,IMPERIAL,Em linha,R21-B16-A00-P01,387,24,0,363
55503,10313,"BARRICA - Ø13 X 23,3 CM",IMPERIAL,Em linha,R09-B09-A01-P01,218,0,0,218
55521,10664,VASO IKEBANA TERRÁRIO - Ø14 X 11 CM,IMPERIAL,Em linha,R08-B10-A01-P02,126,12,90,114
55512,10835,"BOLEIRA FIRENZE C/PÉ - Ø28,5 X 24 CM",IMPERIAL,Em linha,R09-B02-A00-P01,146,4,0,142
55513,10832,"BOLEIRA FIRENZE S/PÉ - Ø28,5 X 18 CM",IMPERIAL,Em linha,R08-B03-A00-P01,393,4,0,389
55518,10575,FRUTEIRA PETIT POA - Ø34 X 8 CM,IMPERIAL,Em linha,R09-B02-A01-P01,133,12,0,121
56118,10847,"QUEIJEIRA GDE SINTRA - Ø20 X 13,5 CM",IMPERIAL,Em linha,R20-B14-A00-P01,484,12,0,472
55514,10562,"QUEIJEIRA PEQ. PETIT POA - Ø16,5 X 12,7 CM",IMPERIAL,Em linha,R09-B01-A01-P02,975,54,0,921
56115,50912,"POTICHE TERRARIO NAPOLEÃO POP - Ø9,5 X 22 CM",IMPERIAL,Em linha,R09-B03-A01-P01,301,12,0,289
55502,10381,BALEIRO C/ TAMPA - Ø10 X 22 CM,IMPERIAL,Em linha,R09-B01-A01-P01,1611,0,0,1611
56137,50910,POTICHE SUCULENTA POP - Ø10 X 22 CM,IMPERIAL,Em linha,R09-B03-A01-P02,372,0,0,372
56268,50914,"POTICHE TERRARIO AQUÁRIO POP - Ø11,5 X 27 CM",IMPERIAL,Em linha,R08-B01-A00-P02,336,0,0,336
56270,50913,"POTICHE TERRARIO DANI POP - Ø11,5 X 27 CM",IMPERIAL,Em linha,R08-B02-A00-P03,513,24,0,489
56271,50911,"POTICHE TERRARIO MARROQUINA POP - Ø11,5 X 27,5 CM",IMPERIAL,Em linha,R08-B02-A00-P01,577,24,60,553
56122,50902,"POTICHE SUCULENTA G - Ø11 X 21,5 CM",IMPERIAL,Em linha,R08-B03-A01-P02,341,0,0,341
56123,50901,POTICHE SUCULENTA M - Ø11 X 18 CM,IMPERIAL,Em linha,R08-B03-A01-P03,135,0,0,135
56124,50900,POTICHE SUCULENTA P - Ø11 X 16 CM,IMPERIAL,Em linha,R08-B04-A01-P01,132,0,0,132
56274,50909,"POTICHE MARACANÃ GDE - Ø15,5 X 22,5 CM",IMPERIAL,Em linha,R09-B04-A01-P01,576,60,360,516
56275,50908,"POTICHE MARACANÃ MED - Ø12,3 X 22 CM",IMPERIAL,Em linha,R09-B01-A00-P01,468,24,480,444
56276,50907,"POTICHE MARACANÃ PEQ - Ø9,5 X 20 CM",IMPERIAL,Em linha,R08-B01-A00-P01,480,24,0,456
55525,10422,"TAÇA BOCA TORTA GDE - Ø16,5 X 19,5 CM",IMPERIAL,Em linha,R08-B06-A00-P01,1315,96,900,1219
55526,10421,"TAÇA BOCA TORTA MÉD - Ø14,5 X 17 CM",IMPERIAL,Em linha,R09-B05-A00-P02,1439,84,420,1355
55527,10420,"TAÇA BOCA TORTA PEQ - Ø11,3 X 14 CM",IMPERIAL,Em linha,R08-B02-A01-P01,1545,0,0,1545
56126,10431,"TACA ASTHURIAS P/DECORACAO - Ø23,5 X 19 CM",IMPERIAL,Em linha,R08-B05-A00-P01,385,12,0,373
55532,10436,"TAÇA NAPOLEÃO - Ø9,5 X 22 CM",IMPERIAL,Em linha,R08-B05-A00-P02,302,12,0,290
55528,10435,"TAÇA CALIFÓRNIA - Ø11 X 30 CM - 1,2 L",IMPERIAL,Em linha,R09-B02-A01-P03,1133,48,0,1085
35819,010838,DAILY TIGELA CEREAL BICOLOR 600 ML - SORTIDA,OXFORD,Em linha,R10-B03-A00-P01,492,0,60,492
35818,010860,DAILY CANECA TULIPA BICOLOR 330 ML - SORTIDA,OXFORD,Em linha,R10-B09-A01-P02,1452,48,240,1404
17536,010845,DAILY CANECA TULIPA 330 ML  COLORIDA,OXFORD,Em linha,R10-B03-A00-P04,2484,84,1440,2400
20551,010848,DAILY CANECA QUARTIER MINI 220 ML  COLORIDA ,OXFORD,Em linha,R09-B10-A00-P01,5580,528,4200,5052
38449,010863,DAILY CANECA FALL 350 ML COLORIDA,OXFORD,Em linha,R10-B08-A01-P03,1860,108,960,1752
20550,010862,DAILY CANECA QUARTIER 350 ML  PRETO / BRANCO,OXFORD,Em linha,R10-B08-A00-P02,1550,72,960,1478
17539,010853,BIONA CANECA AZ-9 270 ML  PRETO / BRANCO,OXFORD,Em linha,R10-B08-A01-P03,1560,0,1800,1560
54904,004221,DAILY CANECA TULIPA 330 ML BRANCA,OXFORD,Em linha,R10-B10-A01-P03,744,0,0,744
54902,010880,DAILY CANECA QUARTIER MINI 220 ML BRANCA,OXFORD,Em linha,R10-B07-A01-P02,2328,12,0,2316
54903,A206-0802,BIONA CANECA AZ-12 360 ML BRANCA,OXFORD,Em linha,R10-B10-A01-P01,2942,72,0,2870
54901,J163-0802,BIONA CANECA JUMBO 740 ML BRANCA,OXFORD,Em linha,R10-B08-A01-P01,1704,12,0,1692
25318,010871,BIONA TIGELA CEREAL 600 ML  BRANCA,OXFORD,Em linha,R10-B10-A01-P02,120,0,240,120
25323,010854,BIONA CANECA AZ-9 270 ML  DECORADA,OXFORD,Em linha,R10-B07-A01-P01,768,12,120,756
17537,010870,BIONA TIGELA CEREAL 600 ML  COLORIDA,OXFORD,Em linha,R10-B05-A01-P03,1837,0,0,1837
20546,010879,BIONA CANECA JUMBO 740 ML  COLORIDA ,OXFORD,Em linha,R11-B01-A00-P04,3072,132,0,2940
20545,010877,BIONA CANECA AZ-12 360 ML  COLORIDA,OXFORD,Em linha,R09-B09-A00-P01,2124,72,3000,2052
35816,039288,BIONA CANECA AZ4 120 ML - COLORIDA,OXFORD,Em linha,R10-B09-A01-P01,804,72,0,732
17538,010875,BIONA CANECA TALL 230 ML  COLORIDA,OXFORD,Em linha,R11-B01-A00-P02,1668,48,1800,1620
28035,008464,BIONA CANECA DROP 250 ML  COLORIDA,OXFORD,Em linha,R10-B09-A01-P03,2532,0,0,2532
28034,008465,BIONA CANECA DROP 250 ML  DECORADA,OXFORD,Em linha,R11-B01-A00-P01,876,36,0,840
48563,074590,DAILY HANA APARELHO DE JANTAR/CHA 20 PÇS,OXFORD,Em linha,R11-B04-A00-P02,69,0,0,69
48566,074562,DAILY HANA PRATO RASO 26 CM,OXFORD,Em linha,R10-B10-A00-P02,252,36,1200,216
48565,074568,DAILY HANA PRATO FUNDO 23 CM,OXFORD,Em linha,R10-B04-A00-P01,816,12,600,804
35814,032346,DAILY LA CARRETA APARELHO JANTAR/CHA C/20 PCS,OXFORD,Em linha,R10-B01-A00-P03,69,0,0,69
35815,034452,DAILY LA CARRETA CJ XICARA CHA C/ PIRES 12 PC,OXFORD,Em linha,R11-B02-A01-P02,93,4,10,89
37054,037602,DAILY LA CARRETA PRATO RASO 26 CM,OXFORD,Em linha,R10-B04-A00-P03,1860,24,0,1836
37055,037027,DAILY LA CARRETA PRATO FUNDO 23 CM,OXFORD,Em linha,R11-B02-A00-P03,336,12,1800,324
33180,005246,DAILY LUIZA APARELHO JANTAR/CHA C/30 PCS,OXFORD,Em linha,R10-B01-A00-P01,30,0,0,30
26002,005243,DAILY LUIZA APARELHO JANTAR/CHA C/20 PCS,OXFORD,Em linha,R10-B02-A00-P02,70,0,0,70
30389,020077,DAILY LUIZA CJ XICARA CAFE C/ PIRES 12 PCS,OXFORD,Em linha,R10-B05-A01-P01,60,2,0,58
37051,005237,DAILY LUIZA PRATO FUNDO 23 CM,OXFORD,Em linha,R10-B03-A00-P02,1848,12,240,1836
46921,075718,DAILY C/RELEVO SWEET APARELHO DE JANTAR/CHÁ 20PÇS,OXFORD,Em linha,R11-B04-A00-P04,73,1,0,72
46922,075717,DAILY C/RELEVO SWEET CJ XÍCARA CHÁ C/PIRES 12 PCS,OXFORD,Em linha,R10-B03-A01-P03,74,0,80,74
46923,075697,DAILY C/RELEVO SWEET PRATO RASO 26 CM,OXFORD,Em linha,R11-B04-A00-P03,900,24,360,876
46924,075691,DAILY C/RELEVO SWEET PRATO FUNDO 23 CM,OXFORD,Em linha,R11-B04-A00-P01,264,12,912,252
48569,074470,DONNA LOLA PRATO FUNDO 22 CM,OXFORD,Em linha,R10-B06-A00-P01,3768,300,2604,3468
56011,074478,DONNA LOLA PRATO SOBREMESA 19 CM,OXFORD,Em linha,R10-B08-A00-P01,878,36,1200,842
37038,005886,DONNA JD ORIENTAL PRATO RASO 24 CM,OXFORD,Em linha,R10-B05-A00-P03,1992,300,3084,1692
37039,005887,DONNA JD ORIENTAL PRATO FUNDO 22 CM,OXFORD,Em linha,R11-B02-A00-P02,2724,216,2412,2508
56013,005888,DONNA JD ORIENTAL PRATO SOBREMESA 19 CM,OXFORD,Em linha,R10-B05-A00-P01,1560,12,756,1548
50093,074322,DONNA HOLAMBRA APARELHO JANTAR/CHA C/20 PCS,OXFORD,Em linha,R10-B02-A00-P03,37,5,60,32
56012,074310,DONNA HOLAMBRA PRATO SOBREMESA 19 CM,OXFORD,Em linha,R10-B07-A00-P01,540,12,1800,528
45400,061419,DONNA FOLK APARELHO JANTAR/CHA C/20 PCS,OXFORD,Em linha,R10-B01-A00-P02,27,3,110,24
45398,061406,DONNA FOLK PRATO FUNDO 22 CM,OXFORD,Em linha,R10-B05-A00-P02,1428,264,4356,1164
32490,022923,DONNA GRECIA APARELHO JANTAR/CHA 20 PCS,OXFORD,Em linha,R11-B06-A00-P03,66,1,60,65
37041,022919,DONNA GRECIA PRATO FUNDO 22 CM,OXFORD,Em linha,R11-B03-A00-P03,612,216,4296,396
56009,090970,DONNA GIARDINO APARELHO JANTAR/CHA 20 PCS,OXFORD,Em linha,R11-B05-A00-P03,49,0,80,49
56008,090962,DONNA GIARDINO PRATO FUNDO 22 CM,OXFORD,Em linha,R10-B09-A00-P03,2028,204,2400,1824
35824,005880,DONNA BRANCO APARELHO JANTAR/CHA C/20 PCS,OXFORD,Em linha,R11-B06-A00-P02,139,4,0,135
35823,023076,DONNA BRANCO CJ XICARA CHA C/ PIRES 12 PCS,OXFORD,Em linha,R10-B05-A01-P02,110,13,80,97
35821,005875,DONNA BRANCO PRATO RASO 24 CMS,OXFORD,Em linha,R10-B07-A00-P03,4068,336,0,3732
35822,005878,DONNA BRANCO XICARA CHA C/ PIRES 200 ML,OXFORD,Em linha,R11-B06-A00-P01,1188,0,0,1188
30391,021200,DAILY COPO TRIP C/ TPA SILICONE 300 ML - SORT,OXFORD,Em linha,R10-B04-A01-P02,72,0,0,72
57033,081117,CRISTAL TAÇA ESPUMANTE 175 ML C/ 06 PCS,OXFORD,Lancamento,R11-B03-A01-P02,64,0,0,64
57032,081114,CRISTAL TAÇA ÁGUA 350 ML C/ 06 PCS,OXFORD,Lancamento,R10-B02-A01-P01,75,1,0,74
57031,081115,CRISTAL TAÇA VINHO 450 ML C/ 06 PCS,OXFORD,Lancamento,R10-B02-A01-P03,42,2,36,40
57034,080656,CRISTAL TAÇA GIN 780 ML C/ 06 PCS,OXFORD,Lancamento,R10-B01-A01-P01,65,0,0,65
17510,004959,PORCELANA ABA PRATO SOBREMESA 20 CMS,OXFORD,Em linha,R11-B02-A00-P03,1092,72,240,1020
17509,004958,PORCELANA ABA PRATO FUNDO 23 CMS,OXFORD,Em linha,R11-B02-A00-P01,480,12,0,468
17507,004954 / I364-9001,PORCELANA ABA PRATO RASO 24 CMS,OXFORD,Em linha,R10-B09-A00-P04,636,0,0,636
17508,004955,PORCELANA ABA PRATO RASO 26 CMS,OXFORD,Em linha,R10-B10-A00-P01,1548,96,0,1452
17514,005035,PORCELANA XICARA CHA EMPILHAVEL C/ PIRES 220 ML,OXFORD,Em linha,R11-B01-A00-P03,1476,108,0,1368
17515,005037,PORCELANA XICARA CAFE EMPILHAVEL C/ PIRES 80 ML,OXFORD,Em linha,R10-B06-A01-P01,960,48,0,912
51118,058819,VITRAMIK PRATO FUNDO 22 CM,OXFORD,Em linha,R10-B03-A00-P03,1252,24,0,1228
51117,058818,VITRAMIK PRATO RASO 24 CM,OXFORD,Em linha,R10-B05-A00-P04,648,216,1200,432
51119,058820,VITRAMIK PRATO SOBREMESA 18 CM,OXFORD,Em linha,R11-B05-A00-P01,108,0,1968,108
51120,058821,VITRAMIK XÍCARA DE CHÁ 180 ML,OXFORD,Em linha,R10-B07-A01-P03,1188,96,600,1092
51121,069519,VITRAMIK XÍCARA DE CAFÉ 65 ML,OXFORD,Em linha,R10-B04-A01-P01,1260,12,0,1248
56545,6,XÍCARA DE CAFÉ 75 ML TRADIÇÃO BRANCA,SF PORCELANA,Em linha,R11-B08-A01-P04,600,0,0,600
56546,6C,XÍCARA DE CAFÉ 75 ML TRADIÇÃO COLORIDA,SF PORCELANA,Em linha,R11-B08-A01-P02,3168,0,0,3168
56547,7,CANECA 200 ML TRADIÇÃO BRANCA,SF PORCELANA,Em linha,R12-B07-A01-P02,360,0,120,360
56548,7C,CANECA 200 ML TRADIÇÃO COLORIDA,SF PORCELANA,Em linha,R12-B10-A01-P03,1080,0,0,1080
54915,32CC,CANECA CANELADA 150 ML COLORIDA,SF PORCELANA,Em linha,R11-B04-A01-P02,696,72,120,624
54916,33CC,CANECA CANELADA 280 ML COLORIDA,SF PORCELANA,Em linha,R11-B07-A00-P02,2016,0,0,2016
54917,34CC,CANECA CANELADA JUMBO 440 ML COLORIDA,SF PORCELANA,Em linha,R11-B07-A00-P01,936,0,0,936
54914,91CC,TIGELA 500ML CANELADA COLORIDA,SF PORCELANA,Em linha,R12-B10-A00-P02,600,0,0,600
56544,24MDC,CANECA 280 ML PRETA DEC ATITUDE C/ CX,SF PORCELANA,Em linha,R12-B08-A01-P03,6000,0,0,6000
56543,24MD,CANECA 280 ML PRETA DEC ATITUDE,SF PORCELANA,Em linha,R11-B07-A00-P03,3576,0,1080,3576
48588,24,CANECA 280 ML BRANCA,SF PORCELANA,Em linha,R12-B09-A01-P02,264,0,360,264
48590,24C,CANECA 280 ML COLORIDA,SF PORCELANA,Em linha,R11-B09-A00-P01,1920,48,0,1872
48591,24DA,CANECA 280 ML DEC CHOCOLATE C/CX,SF PORCELANA,Em linha,R12-B09-A00-P02,1821,96,0,1725
48589,24D,CANECA 280 ML DEC CHOCOLATE,SF PORCELANA,Em linha,R11-B06-A01-P03,1560,72,0,1488
48621,5P,XÍCARA CAFÉ 75ML COM PIRES BRANCA,SF PORCELANA,Em linha,R12-B10-A01-P01,624,0,240,624
48616,5,XÍCARA CAFÉ 75ML BRANCA,SF PORCELANA,Em linha,R11-B08-A01-P03,552,96,480,456
48627,15P,XÍCARA CHÁ 175 ML COM PIRES BRANCA,SF PORCELANA,Em linha,R11-B08-A00-P01,600,0,1200,600
48622,15,XÍCARA CHÁ 175 ML BRANCA,SF PORCELANA,Em linha,R11-B04-A01-P03,1056,72,480,984
48612,81,RAMEKIN 40ML  6 X 3 CM,SF PORCELANA,Em linha,R11-B06-A01-P02,2160,0,600,2160
48613,82,"RAMEKIN 80ML  7,3 X 3,3 CM",SF PORCELANA,Em linha,R11-B05-A01-P04,360,0,2400,360
48614,83,"RAMEKIN 125ML  8,5 X 4 CM",SF PORCELANA,Em linha,R12-B08-A01-P01,2160,0,960,2160
48615,84,"RAMEKIN 275 ML  10,5 X 5,3 CM",SF PORCELANA,Em linha,R12-B09-A01-P04,1368,24,1800,1344
56005,18MDC,CANECA 220 ML PRETA DEC ATITUDE C/CX,SF PORCELANA,Em linha,R12-B08-A00-P01,4956,192,960,4764
56006,18MD,CANECA 220 ML PRETA DEC ATITUDE,SF PORCELANA,Em linha,R12-B10-A00-P03,2088,192,3840,1896
48584,18,CANECA 220 ML BRANCA,SF PORCELANA,Em linha,R11-B08-A01-P03,409,0,240,409
48586,18C,CANECA 220 ML COLORIDA,SF PORCELANA,Em linha,R11-B05-A01-P03,1536,24,0,1512
54909,18DBC,CANECA 220 ML DEC FAMÍLIA C/CX,SF PORCELANA,Em linha,R11-B10-A01-P01,1608,48,0,1560
54908,18DBB,CANECA 220 ML DEC FAMÍLIA,SF PORCELANA,Em linha,R11-B10-A01-P03,6768,48,0,6720
48583,19 L,CANECA 200 ML DEC CAFÉ C/CX,SF PORCELANA,Em linha,R11-B07-A01-P01,1848,48,360,1800
48581,19 d,CANECA 200 ML DEC CAFÉ,SF PORCELANA,Em linha,R11-B04-A01-P04,3024,24,0,3000
48580,19,CANECA 200 ML BRANCA,SF PORCELANA,Em linha,R12-B10-A01-P02,204,0,120,204
48582,19C,CANECA 200 ML COLORIDA,SF PORCELANA,Em linha,R12-B09-A01-P03,1656,48,0,1608
54907,31DBC,CANECA 120 ML DEC BORBOLETA C/CX,SF PORCELANA,Em linha,R11-B10-A01-P02,528,24,1200,504
54906,31DFB,CANECA 120 ML DEC BORBOLETA,SF PORCELANA,Em linha,R11-B09-A01-P03,1008,48,840,960
48576,31,CANECA 120 ML BRANCA,SF PORCELANA,Em linha,R11-B08-A01-P01,264,0,120,264
48578,31C,CANECA 120 ML COLORIDA,SF PORCELANA,Em linha,R11-B05-A01-P02,1224,24,840,1200
54919,28BB,XICARA CHÁ CREMOSA 210 ML BORBOLETA,SF PORCELANA,Em linha,R12-B08-A01-P02,1920,0,240,1920
54913,91DBC,TIGELA 500ML DEC BORBOLETA C/CX,SF PORCELANA,Em linha,R12-B10-A00-P01,360,24,0,336
48595,91,TIGELA 500ML BRANCA,SF PORCELANA,Em linha,R11-B09-A00-P03,312,0,0,312
54912,91DBB,TIGELA 500ML DEC BORBOLETA,SF PORCELANA,Em linha,R11-B10-A00-P02,240,0,240,240
54911,91SDBC,SOPEIRA 500ML DEC BORBOLETA C/CX,SF PORCELANA,Em linha,R11-B08-A00-P03,384,24,0,360
48599,91SB,SOPEIRA 500ML BRANCA,SF PORCELANA,Em linha,R11-B08-A00-P02,504,0,0,504
54910,91SDBB,SOPEIRA 500ML DEC BORBOLETA,SF PORCELANA,Em linha,R11-B09-A00-P02,504,0,0,504
48619,5D/BA4,XÍCARA CAFÉ 75ML DECORADA BANDEJA COM 4,SF PORCELANA,Em linha,R11-B06-A01-P01,38,18,180,20
48617,5D,XÍCARA CAFÉ 75ML DECORADA,SF PORCELANA,Em linha,R11-B05-A01-P01,240,0,1560,240
48625,15D/BA4,XÍCARA CHÁ 175 ML DECORADA BANDEJA COM 4,SF PORCELANA,Em linha,R11-B07-A01-P03,36,12,210,24
48623,15D,XÍCARA CHÁ 175 ML DECORADA,SF PORCELANA,Em linha,R11-B09-A01-P01,960,0,0,960
48606,41,CUMBUCA 300ML BRANCA,SF PORCELANA,Em linha,R12-B07-A01-P01,336,0,0,336
48607,41D,CUMBUCA 300ML DECORADA,SF PORCELANA,Em linha,R11-B07-A01-P02,192,24,0,168
48609,42,CUMBUCA 470ML BRANCA,SF PORCELANA,Em linha,R11-B10-A00-P03,984,0,0,984
48610,42D,CUMBUCA 470ML DECORADA,SF PORCELANA,Em linha,R12-B09-A00-P01,192,0,120,192
48592,26,CANECA JUMBO 440 ML BRANCA,SF PORCELANA,Em linha,R12-B08-A00-P02,24,0,240,24
48593,26D,CANECA JUMBO 440 ML DECORADA,SF PORCELANA,Em linha,R11-B10-A00-P01,672,24,0,648
48594,26C,CANECA JUMBO 440 ML COLORIDA,SF PORCELANA,Em linha,R12-B07-A00-P01,960,0,0,960
56550,36C,"CACHEPO SUCULENTA COLORIDA - Ø9 X 6,5 CM",SF PORCELANA,Em linha,R11-B04-A01-P01,84,12,240,72
56549,37C,"CACHEPO VIOLETA COLORIDA - Ø10,8 X 8 CM",SF PORCELANA,Em linha,R11-B09-A01-P02,240,0,120,240
56974,0013,CANECA 220ML DECORADA CAFÉ DA MANHÃ,PORCELANAS LU,Lancamento,R12-B05-A00-P01,3312,24,1440,3288
56973,1316,CANECA 220ML BRANCA,PORCELANAS LU,Lancamento,R12-B04-A00-P02,504,24,0,480
56976,37860,CANECA 210ML DECORADA FRASES,PORCELANAS LU,Lancamento,R12-B01-A00-P02,4320,264,1440,4056
56975,37359,CANECA 210ML BRANCA,PORCELANAS LU,Lancamento,R12-B03-A00-P01,480,24,0,456
56978,0018,CANECA 280ML DECORADA NATAL,PORCELANAS LU,Lancamento,R12-B01-A00-P01,6408,672,5400,5736
56977,1070,CANECA 280ML BRANCA,PORCELANAS LU,Lancamento,R12-B04-A00-P02,816,48,0,768
56979,51508,CANECA 120ML CANELADA COLORIDA,PORCELANAS LU,Lancamento,R12-B02-A00-P02,3696,192,0,3504
56980,51509,CANECA 120ML CANELADA BRANCA,PORCELANAS LU,Lancamento,R12-B03-A00-P03,432,24,120,408
56981,51501,CANECA 220ML CANELADA COLORIDA,PORCELANAS LU,Lancamento,R12-B03-A00-P02,3576,48,0,3528
56982,51502,CANECA 220ML CANELADA BRANCA,PORCELANAS LU,Lancamento,R12-B02-A00-P01,312,24,120,288
56943,TW-206-2,PRATO RASO 25 CM,ATLAS,Lancamento,R12-B06-A00-P02,5448,72,0,5376
56950,TW-101-2,"POTE / TIGELA 270 ML - Ø11,5 X 6 CM",ATLAS,Lancamento,R12-B04-A01-P01,444,0,240,444
56951,TW-120-2,BOWL 470 ML - Ø13 X 7 CM,ATLAS,Lancamento,R12-B03-A01-P02,432,0,0,432
56952,TW-121-2,BOWL 600 ML - Ø14 X 8 CM,ATLAS,Lancamento,R12-B04-A01-P02,348,48,120,300
56946,TW-140-2,"RAMEQUIM 50 ML - Ø6,0 X 3,5 CM",ATLAS,Lancamento,R12-B03-A01-P01,768,144,0,624
56948,TW-142-2,"RAMEQUIM 150 ML - Ø8,5 X 4,5 CM",ATLAS,Lancamento,R12-B03-A01-P03,984,36,240,948
56949,TW-143-2,"RAMEQUIM 340 ML - Ø10,5 X 6 CM",ATLAS,Lancamento,R12-B05-A01-P01,348,0,600,348
56953,TW-510-2,XICARA CAFÉ 70 ML C/ PIRES QUENIA,ATLAS,Lancamento,R12-B05-A01-P03,576,48,0,528
56955,TW-502-2,XICARA CAFÉ 70 ML C/ PIRES EMPILHAVEL PACA,ATLAS,Lancamento,R12-B06-A01-P01,672,96,0,576
56957,TW-004-2,XICARA CAFÉ 70 ML S/ PIRES MOCA,ATLAS,Lancamento,R12-B04-A01-P03,1236,0,0,1236
56958,TW-022-2,XICARA CHÁ 210 ML S/ PIRES MOCA,ATLAS,Lancamento,R12-B06-A01-P03,1164,24,0,1140
56959,TW-006-2,XICARA CAFÉ 70 ML S/ PIRES KOPI,ATLAS,Lancamento,R12-B05-A01-P02,1308,132,0,1176
56960,TW-023-2,XICARA CHÁ 200 ML S/ PIRES KOPI,ATLAS,Lancamento,R12-B06-A01-P02,600,12,0,588
20543,03052-03,BULE TERMICO VERONA FLORAL 750 ML - MELANCIA/ACQUA,ALADDIN,Em linha,R13-B03-A00-P02,83,2,120,81
10280,03051-13,BULE TERMICO 750 ML - PRETO/BRANCO,ALADDIN,Em linha,R13-B08-A01-P02,325,0,0,325
20541,03096-01,GARRAFA TERM KIDS 250 ML - PRETA/BRANCA,ALADDIN,Em linha,R13-B08-A00-P02,166,0,0,166
40444,03072-01,BULE TERMICO VERONA 750 ML - NUDE/CINZA,ALADDIN,Em linha,R13-B07-A00-P02,270,2,30,268
17387,00403-01,CANTIL TERMICO 01 LT - MELANCIA,ALADDIN,Em linha,R13-B05-A00-P03,210,6,0,204
35858,00406-02,CANTIL TERM KIDS MENINO 300 ML - AZUL ESCURO/AZUL,ALADDIN,Em linha,R13-B07-A00-P03,211,6,0,205
17388,05001-03,JARRA TERMICA LISA 2 LTS  -  MELANCIA/ACQUA,ALADDIN,Em linha,R13-B06-A01-P01,364,5,0,359
12797,01406-02,GARRAFAO TERMICO INOVARE 5 LTS  VERMELHO,ALADDIN,Em linha,R13-B09-A00-P03,228,0,0,228
7386,03028-11,GARRAFA TERM CONTIN 500 ML  - PRETA/MARRON,ALADDIN,Em linha,R13-B08-A00-P02,1682,164,210,1518
50100,03536-04,GARRAFA TERM CONTIN 500 ML - PRETA/MELANCIA,ALADDIN,Em linha,R14-B10-A00-P02,1492,16,0,1476
51070,00997-03,GARRAFA TERM CONTIN 500 ML - PLUS LISA,ALADDIN,Em linha,R13-B05-A01-P02,131,12,30,119
7385,03027-08,GARRAFA TERM CONTINENTAL 1 LT - PRETA/MARRON,ALADDIN,Em linha,R13-B03-A00-P01,1736,143,420,1593
33186,03532-04,GARRAFA TERM CONTINENTAL 1 LT - MELANCIA/PRETA,ALADDIN,Em linha,R13-B06-A01-P03,1220,30,0,1190
34694,03302-01,GARRAFA TERM CONTIN PLUS 500 ML - MELANCIA/PRETA,ALADDIN,Em linha,R13-B10-A00-P02,386,3,0,383
33188,03229-03,GARRAFA TERM CONTIN PLUS DEC 500 ML - MARRON/CREME,ALADDIN,Em linha,R13-B06-A01-P02,332,33,0,299
34693,02052-01,GARRAFA TERM CHIMAS GAUCHO 01 LT - MARROM/CREME,ALADDIN,Em linha,R13-B10-A01-P01,279,15,30,264
34691,02055-00,GARRAFA TERM PAMPA 01 LT - CREME/MARRON,ALADDIN,Em linha,R13-B08-A01-P03,269,12,360,257
46909,02060-00,GARRAFA TERM PAMPA 01 LT - CINZA/NUDE,ALADDIN,Em linha,R13-B09-A01-P01,678,22,0,656
50099,03506-02,GARRAFA TERM FUTURA 750 ML - PRETA,ALADDIN,Em linha,R13-B06-A00-P01,713,0,0,713
33187,03409-03,GARRAFA TERM FUTURA 750 ML -AZUL / LARANJA,ALADDIN,Em linha,R13-B03-A00-P03,341,6,0,335
7392,03021-21,GARRAFA TERM FUTURA 750 ML - MELANCIA/ACQUA,ALADDIN,Em linha,R13-B07-A00-P01,1287,103,0,1184
40443,03037-01,GARRAFA TERM FUTURA 750 ML - NUDE/CINZA,ALADDIN,Em linha,R13-B05-A01-P01,712,2,0,710
12796,03101-01,GARRAFA TERM TRADICAO 1 LT - PRETA,ALADDIN,Em linha,R13-B09-A01-P03,92,18,60,74
54899,2062,GARRAFA TERM ARES 1L PRETO,ALADDIN,Em linha,R13-B05-A00-P02,271,4,0,267
54900,2064,GARRAFA TERM ARES 1L CREME,ALADDIN,Em linha,R13-B06-A00-P02,865,27,0,838
23538,03861-03,GARRAFA TERM RATTAN 01 LT - CREME/MARRON,ALADDIN,Em linha,R13-B07-A01-P02,445,6,60,439
11657,03327-08,GARRAFA TERM COFFE LINE 1 LT - CAFE/MARRON,ALADDIN,Em linha,R13-B10-A00-P03,180,15,0,165
7389,03264-11,GARRAFA TERM MADRID 1 LT - PRETA/BRANCA,ALADDIN,Em linha,R14-B10-A00-P01,541,0,0,541
56572,03240-00,GARRAFA TERM MASSIMA ROLHA 1L BRANCA / PRETA,ALADDIN,Em linha,R13-B09-A00-P02,111,6,30,105
51068,01222-00,GARRAFA TERM MASSIMA PRESSAO 500 ML - BABY,ALADDIN,Em linha,R13-B08-A00-P01,58,0,0,58
51067,03304-00,GARRAFA TERM MASSIMA PRESSAO 1L - PRETA,ALADDIN,Em linha,R13-B10-A02-P04,148,7,90,141
50101,03324-00,GARRAFA TERM MASSIMA PRESSAO 1L - BEST COFFEE,ALADDIN,Em linha,R13-B08-A01-P01,233,16,0,217
51066,03262-00,GARRAFA TERM MASSIMA PRESSAO 1L - FIORE,ALADDIN,Em linha,R13-B10-A01-P02,184,8,0,176
51065,03819-00,GARRAFA TERM MASSIMA PRESSAO 1L - COFFE FOREVER,ALADDIN,Em linha,R13-B10-A02-P03,110,3,0,107
51069,01223-00,GARRAFA TERM MASSIMA PRESSAO 1L - INOX,ALADDIN,Em linha,R13-B07-A01-P01,41,1,30,40
52667,03886-00,"GARRAFA TERM MASSIMA PRESSÃO 1,8L INOX",ALADDIN,Em linha,R13-B05-A00-P01,81,4,0,77
52665,03885-00,"GARRAFA TERM MASSIMA PRESSAO 1,8L PRETA",ALADDIN,Em linha,R14-B10-A00-P03,198,12,0,186
52666,03889-00,"GARRAFA TERM MASSIMA PRESSAO 1,8L BEST COFFEE",ALADDIN,Em linha,R13-B07-A01-P03,122,2,0,120
38173,101528512030,"POTE QUADRADO 1,3 L TAMPA METALIZADA ",INVICTA,Ponta de Estoque,R24-B27-A00-P01,636,24,0,612
56227,101528052121,POTE LISO 750 ML TAMPA METALIZADA,INVICTA,Em linha,R14-B04-A01-P02,468,24,0,444
56225,101528012121,"POTE LISO 1,3 L TAMPA METALIZADA ",INVICTA,Em linha,R14-B04-A01-P01,576,36,0,540
56226,101528082121,"POTE LISO 2,5 L TAMPA METALIZADA",INVICTA,Em linha,R14-B06-A00-P02,750,24,0,726
52863,101528512046,"POTE QUADRADO 1,3 L TAMPA MARBLE",INVICTA,Ponta de Estoque,R24-B25-A00-P01,4956,96,0,4860
52865,101528472046,POTE QUADRADO 2 L TAMPA MARBLE,INVICTA,Ponta de Estoque,R24-B26-A00-P01,1254,132,0,1122
56230,101528052046,POTE LISO 750 ML TAMPA MARBLE,INVICTA,Em linha,R15-B02-A00-P02,1068,48,0,1020
56228,101528012046,"POTE LISO 1,3 L TAMPA MARBLE",INVICTA,Em linha,R14-B03-A01-P02,948,36,0,912
56229,101528082046,"POTE LISO 2,5 L TAMPA MARBLE",INVICTA,Em linha,R14-B01-A00-P01,1230,78,0,1152
42132,101528512029,"POTE LISO 1,3 L TAMPA DECORADA",INVICTA,Em linha,R14-B03-A00-P02,1344,36,0,1308
8523,101528052026,POTE LISO 750 ML,INVICTA,Em linha,R24-B17-A00-P01,2796,120,900,2676
8522,101528012026,POTE LISO 1.3 LITROS,INVICTA,Em linha,R24-B13-A00-P01,4107,288,2400,3819
56241,101528212121,"POTE 0,75L  TENDENZA METALIZADO DOURADO/BRONZE",INVICTA,Em linha,R15-B02-A00-P03,900,24,0,876
56242,101528222121,"POTE 1,3L TENDENZA METALIZADO DOURADO /BRONZE",INVICTA,Em linha,R14-B04-A00-P02,900,36,660,864
56243,101528232121,POTE 2L TENDENZA METALIZADO DOURADO/BRONZE,INVICTA,Em linha,R14-B09-A00-P02,408,24,120,384
56238,101528212046,"POTE 0,75L TENDENZA BRANCO CARRARA/MARROM",INVICTA,Em linha,R14-B01-A00-P02,1476,0,480,1476
56239,101528222046,"POTE 1,3L TENDENZA BRANCO CARRARA/MARROM",INVICTA,Em linha,R14-B09-A00-P01,804,12,0,792
56240,101528232046,POTE 2L TENDENZA BRANCO CARRARA/MARROM,INVICTA,Em linha,R15-B02-A00-P03,576,0,0,576
56235,101528212026,"POTE 0,75L TENDENZA PRETO/BRANCO/VERMELHO",INVICTA,Em linha,R14-B02-A00-P02,360,12,600,348
56236,101528222026,"POTE 1,3L TENDENZA PRETO/BRANCO/VERMELHO",INVICTA,Em linha,R15-B02-A00-P01,732,12,900,720
21209,100396012021,BULE VIENA 400 ML  -  ROSA / AZUL,INVICTA,Em linha,R14-B02-A01-P01,154,0,0,154
49927,100396512021,BULE VIENA 750 ML MIX ROSA/AZUL,INVICTA,Em linha,R14-B07-A01-P01,251,7,0,244
34058,100396010105,BULE VIENA 400 ML  - PRETO,INVICTA,Lancamento,R14-B05-A01-P01,133,10,0,123
57011,100396510105,BULE VIENA 750 ML - PRETO,INVICTA,Lancamento,R15-B01-A00-P01,171,13,0,158
39702,100396212034,BULE VIENA DECORADO 750 ML,INVICTA,Em linha,R14-B09-A01-P03,226,6,0,220
49924,100396412101,BULE METALIZADO 750 ML BRONZE,INVICTA,Em linha,R15-B01-A01-P02,74,0,0,74
49926,100300040105,BULE VIENA C/ GATILHO 1L PRETO,INVICTA,Em linha,R14-B09-A01-P02,72,8,0,64
39701,100300042022,BULE VIENA C/ GATILHO 01 LT  -  CORAL / CAPPUCCINO,INVICTA,Em linha,R14-B08-A01-P03,158,8,0,150
8686,100197280105,"GARRAFA TERMICA AIR POT INOX 1,8 LT",INVICTA,Em linha,R15-B01-A01-P04,84,0,0,84
34056,100100020105,"GARRAFA TERMICA INOX SLIM 1,8 LTS",INVICTA,Em linha,R14-B10-A01-P01,51,7,0,44
49921,100200010105,"GARRAFA TERMICA AIR POT PP 1,8L PRETA",INVICTA,Em linha,R14-B02-A01-P02,80,4,0,76
9435,100773222037,GARRAFA TERMICA GLT PRESSAO DEC 500 ML,INVICTA,Em linha,R15-B01-A01-P03,113,2,0,111
9432,100783222039,GARRAFA TERMICA GLT DEC 500 ML,INVICTA,Em linha,R14-B02-A01-P03,263,18,0,245
57013,100783120105,GARRAFA TERMICA GLT LISA 500 ML- PRETO,INVICTA,Lancamento,R14-B07-A01-P03,107,7,0,100
9434,100773212036,GARRAFA TERMICA GLT PRESSAO DEC 1 LT,INVICTA,Em linha,R15-B02-A02-P01,158,8,0,150
9431,100783212038,GARRAFA TERMICA GLT DEC 1 LT,INVICTA,Em linha,R14-B03-A00-P03,245,23,0,222
57012,100783110105,GARRAFA TERMICA GLT LISA 01 LT - PRETO,INVICTA,Lancamento,R14-B07-A00-P01,166,12,0,154
21212,100773112024,GARRAFA TERMICA GLT PRESSAO 01 LT - VERDE/CORAL,INVICTA,Em linha,R14-B07-A00-P02,238,6,0,232
52631,100783311832,GARRAFA TERMICA GLT MOSAIC 01 LT,INVICTA,Em linha,R14-B10-A01-P03,141,6,0,135
49922,100783212042,GARRAFA TERMICA GLT 1L MIX GOURMET,INVICTA,Em linha,R14-B07-A00-P03,206,0,0,206
32126,100776210121,GARRAFA TERMICA GLT METALIZADA 01 LT,INVICTA,Em linha,R15-B01-A01-P01,161,10,0,151
17250,100197410105,GARRAFA TERMICA INOX NEW 01 LT,INVICTA,Em linha,R14-B05-A01-P02,59,0,0,59
17253,100773110105,GARRAFA TERMICA GLT PRESSAO LISA PRETA 01 LT,INVICTA,Em linha,R14-B06-A01-P02,168,22,0,146
9426,100581211827,GARRAFA TERMICA TOP WAVE DEC 1 LT,INVICTA,Em linha,R14-B10-A01-P02,197,6,0,191
37063,101800032033,GARRAFA TERMICA FIRENZE INFANTIL 250ML,INVICTA,Em linha,R15-B01-A00-P03,151,1,0,150
37062,101800032020,GARRAFA TERMICA FIRENZE MINI 250ML,INVICTA,Em linha,R14-B09-A00-P03,182,0,0,182
28132,101800012040,GARRAFA TERMICA FIRENZE DECORADA 1 LT,INVICTA,Em linha,R14-B08-A00-P03,155,8,30,147
28130,101800012020,GARRAFA TERMICA FIRENZE LISA 1 LT - CORAL/AMARELO,INVICTA,Em linha,R14-B05-A01-P03,135,0,0,135
15433,101184310105,GARRAFA TERMICA IDEAL 1 LT PRETO,INVICTA,Em linha,R14-B08-A01-P01,111,0,30,111
8652,100688032045,GARRAFA TERMICA VG 750 ML - VERM / VERDE,INVICTA,Em linha,R14-B05-A00-P02,584,8,0,576
34060,100688030105,GARRAFA TERMICA VG 750 ML - PRETA,INVICTA,Em linha,R14-B08-A00-P02,460,14,0,446
52632,100688032015,GARRAFA TERMICA VG 750 ML - WOOD,INVICTA,Em linha,R14-B06-A00-P01,40,0,0,40
17248,101080141808,GARRAFA TERMICA LIDER 320 ML VERMELHA,INVICTA,Em linha,R14-B05-A00-P03,473,31,0,442
56231,101080140105,GARRAFA TERMICA LIDER 320 ML PRETA,INVICTA,Em linha,R14-B06-A01-P03,333,32,210,301
8515,101080121808,GARRAFA TERMICA LIDER 500 ML VERMELHA,INVICTA,Em linha,R14-B07-A01-P02,355,24,0,331
56232,101080120105,GARRAFA TERMICA LIDER 500 ML PRETA,INVICTA,Em linha,R14-B08-A01-P02,179,10,0,169
49920,101100060105,"GARRAFA TERMICA EUREKA 0,75 LT PRETA",INVICTA,Em linha,R15-B01-A02-P02,421,44,0,377
49923,101100061808,"GARRAFA TERMICA EUREKA 0,75L VERMELHO",INVICTA,Em linha,R14-B06-A01-P01,295,6,0,289
39239,101100052006,GARRAFA TERMICA EUREKA 1 LT AZUL,INVICTA,Em linha,R15-B01-A01-P05,577,14,0,563
39240,101100050105 ,GARRAFA TERMICA EUREKA 1 LT PRETA,INVICTA,Em linha,R14-B05-A00-P01,569,67,0,502
49919,101100051808,GARRAFA TERMICA EUREKA 1 LT VERMELHA,INVICTA,Em linha,R14-B03-A00-P01,407,12,0,395
57015,101487132006,RECIPIENTE TERMICO MARATONA 3L AZUL,INVICTA,Lancamento,R14-B02-A00-P01,193,0,60,193
57014,101487152006,RECIPIENTE TERMICO MARATONA 5L AZUL,INVICTA,Lancamento,R14-B04-A00-P01,241,15,0,226
11052,101487092006,RECIPIENTE TERMOPLASTICO 09 LTS,INVICTA,Em linha,R15-B01-A00-P02,64,0,0,64
51081,101387341807,RECIPIENTE TERMOPLASTICO 34 LTS AZUL,INVICTA,Em linha,R14-B01-A01-P02,408,15,0,393
28135,101387481310,"RECIPIENTE TERMOPLASTICO COLEMAN 45,4 LTS - AZUL",INVICTA,Em linha,R14-B04-A01-P01,33,0,0,33
23579,07-cx-003,CAIXA DE ISOPOR   3 L - 23 X 14 X 18 CM,PLACTERM,Em linha,R02-B00-A00-P01,1575,109,480,1466
23580,07-CX-007,CAIXA DE ISOPOR   7 L - 28 X 19 X 22 CM ,PLACTERM,Em linha,R07-B00-A00-P01,1364,955,4980,409
23581,07-cx-012,CAIXA DE ISOPOR  12 L - 34 X 23 X 31 CM ,PLACTERM,Em linha,R10-B00-A00-P01,144,116,2148,28
23582,07-cx-017,CAIXA DE ISOPOR  17 L - 37 X 23 X 32 CM ,PLACTERM,Em linha,R17-B00-A00-P01,1229,91,220,1138
55749,07-CX-021,CAIXA DE ISOPOR  21 L - 42 X 24 X 35 CM,PLACTERM,Em linha,R22-B00-A00-P01,951,51,390,900
23583,07-cx-026,CAIXA DE ISOPOR  26 L - 42 X 24 X 41 CM ,PLACTERM,Em linha,R26-B00-A00-P01,737,24,275,713
23584,07-CX-035,CAIXA DE ISOPOR  35 L-46 X 31 X 40 CM ,PLACTERM,Em linha,R30-B00-A00-P01,748,20,140,728
23585,07-cx-045,CAIXA DE ISOPOR  45 L - 36 X 44 X 45 CM,PLACTERM,Em linha,R34-B00-A00-P01,116,13,510,103
55750,07-CX-050,CAIXA DE ISOPOR  50 - 61 X 41 X 37 CM,PLACTERM,Em linha,R38-B00-A00-P01,128,7,170,121
23586,07-CX-060,CAIXA DE ISOPOR  60 L - 44 X 69 X 38 CM,PLACTERM,Em linha,R42-B00-A00-P01,152,5,30,147
23587,07-cx-080,CAIXA DE ISOPOR  80 L -73 X 51 X 38 CM C/ DRENO,PLACTERM,Em linha,R46-B00-A00-P01,111,3,20,108
23589,07-cx-130,CAIXA DE ISOPOR 130 L - 81 X 56 X 52 CM - C/ DRENO,PLACTERM,Em linha,R49-B00-A00-P01,55,1,10,54
23590,07-CX-170,CAIXA DE ISOPOR 170 L - 85 X 61 X 54 CM - C/ DRENO,PLACTERM,Em linha,R51-B00-A00-P01,21,0,35,21
31380,126140,MARMITA TERMICA C/TPA ROSCA 01 LT,GUFANI,Em linha,R13-B01-A00-P02,2447,146,0,2301
11568,116001,"MARMITA TERMICA SIMPLES C/ TAMPA 1,5 LTS",GUFANI,Em linha,R13-B01-A01-P01,868,47,600,821
11574,131260,"MARMITA TERMICA SUPER C/ ROSCA 1,5 LTS",GUFANI,Em linha,R13-B02-A01-P02,966,37,0,929
11570,116208,CJ MARMITA TERMICA C/02 PCS E TAMPA,GUFANI,Em linha,R13-B04-A01-P02,312,11,0,301
11571,116308,CJ MARMITA TERMICA C/03 PCS E TAMPA,GUFANI,Em linha,R13-B01-A01-P02,368,2,0,366
57223,116408,CJ MARMITA TERMICA C/04 PCS E TAMPA,GUFANI,Lancamento,R12-B01-A01-P01,404,16,0,388
11572,116508,CJ MARMITA TERMICA C/05 PCS E TAMPA,GUFANI,Em linha,R13-B03-A01-P01,142,18,240,124
29583,062201,JARRA TERMICA 02 LTS     AZUL / VERM,GUFANI,Em linha,R13-B04-A01-P01,549,8,0,541
11573,060100,CANTIL TERMICO 01 LT,GUFANI,Em linha,R13-B02-A00-P02,366,5,180,361
29584,026301,GARRAFA TERMICA BABY S/ ALCA 300 ML    AZUL / ROSA,GUFANI,Em linha,R13-B02-A01-P01,131,18,60,113
29585,009030,CESTO P/ MERCADO 20 LTS AZUL / VERM  - 45X29X20 CM,GUFANI,Em linha,R13-B02-A00-P01,324,0,360,324
51672,6834,DISPENSER 2L DUBLIN/BRANDON,LYOR,Em linha,R15-B03-A01-P03,33,0,0,33
52615,6478,JG C/ 6 TAÇAS P/VINHO 265ML LIBÉLULA TRANSP,LYOR,Em linha,R15-B04-A00-P01,38,17,40,21
52873,6462,JG C/ 6 TAÇAS P/VINHO 265ML BICO DE ABACAXI,LYOR,Em linha,R15-B03-A00-P01,48,20,0,28
56173,1317,AÇUCAREIRO 210 ML C/TPA COLMEIA C/COLHER ,LYOR,Em linha,R15-B07-A01-P01,225,0,0,225
55161,7443,MELEIRA 210 ML C/PEGADOR E TPA COLMEIA,LYOR,Em linha,R15-B06-A00-P03,261,1,0,260
56561,1667,"BOWL KING 10 X 4,5 CM",LYOR,Em linha,R15-B06-A00-P02,618,24,0,594
52596,7085,"AÇUCAREIRO C/TPA DE AÇO INOX 7,5 X 14 CM",LYOR,Em linha,R16-B09-A00-P02,144,0,0,144
54976,7506,AÇUCAREIRO 100ML C/TPA VERM. C/COLHER TRANSP,LYOR,Em linha,R15-B06-A00-P01,360,0,0,360
57229,7220,MOLHEIRA 175 ML DUBLIN,LYOR,Lancamento,R16-B10-A01-P01,251,4,0,247
52608,7088,CJ C/ 4PCS GALHETEIRO C/SUP METAL PRETO 200ML/70ML,LYOR,Em linha,R15-B05-A01-P03,32,2,40,30
57228,1244,GARRAFA 200ML P/ AZEITE C/TPA PRETO ,LYOR,Lancamento,R16-B10-A01-P02,330,12,0,318
55819,7510,SALEIRO 80 ML,LYOR,Lancamento,R15-B05-A01-P01,384,24,0,360
52599,7624,CANECA P/CHOPP E CERVEJA CAVEIRA 510ML CINZA,LYOR,Em linha,R15-B04-A00-P03,222,0,0,222
55801,7412,CANECA P/CHOPP E CERVEJA CAVEIRA 510ML RAINBOW,LYOR,Em linha,R15-B07-A00-P03,230,0,120,230
56168,7413,CANECA P/CHOPP E CERVEJA CAVEIRA 510 ML ROCK COLOR,LYOR,Em linha,R15-B03-A00-P03,127,0,0,127
56169,7786,CANECA P/CHOPP E CERVEJA CAVEIRA 510 ML ROCK FOSCA,LYOR,Em linha,R15-B04-A00-P02,1044,0,0,1044
51665,6623,CANECA P/CHOPP E CERVEJA CAVEIRA 510ML,LYOR,Em linha,R15-B10-A00-P01,462,0,360,462
51664,7214,CANECA P/CHOPP E CERVEJA CAVEIRA 365ML,LYOR,Em linha,R15-B09-A00-P01,535,0,540,535
56166,6621,CANECA C/TAMPA E CANUDO 400 ML CAVEIRA ROCK STYLE,LYOR,Em linha,R15-B05-A01-P02,192,0,840,192
52597,7130,CANECA C/TAMPA E CANUDO 105 ML CAVEIRA ROCK STYLE,LYOR,Em linha,R15-B05-A00-P02,1080,0,0,1080
52872,7840,JG C/ 6 TAÇAS P/LICOR 50ML ATHENAS,LYOR,Em linha,R15-B08-A01-P02,107,4,0,103
51677,7062,JARRA 785ML MEDIDOR,LYOR,Em linha,R15-B10-A01-P03,186,0,0,186
56167,7473,CANECA FACES 400 ML,LYOR,Em linha,R15-B07-A00-P01,186,12,72,174
57226,1321,TAÇA P/ LICOR 55 ML SORTIDA,LYOR,Lancamento,R16-B10-A00-P01,564,36,288,528
57224,1320,COPO P/ SHOT 65 ML SORTIDO,LYOR,Lancamento,R15-B01-A00-P02,612,12,0,600
57225,1668,COPO P/ SHOT 50 ML CORAÇÃO,LYOR,Lancamento,R15-B10-A01-P01,852,156,0,696
52625,7748,XÍCARA 200 ML LILE,LYOR,Em linha,R15-B04-A01-P01,444,6,144,438
56147,1220,XÍCARA 200 ML RENAISSANCE,LYOR,Em linha,R15-B09-A00-P03,378,12,0,366
56172,7760,TAÇA P/CAPPUCCINO 142 ML C/ALÇA E PÉ DIAMANTE,LYOR,Em linha,R16-B10-A00-P03,636,18,0,618
56555,1382,XÍCARA P/CHÁ 200 ML RENAISSANCE,LYOR,Em linha,R15-B05-A00-P03,528,12,0,516
57227,1588,XÍCARA P/ CAFÉ 85 ML RENAISSANCE,LYOR,Lancamento,R16-B10-A01-P03,486,24,0,462
54969,7802,"PORTA MANTIMENTO 0,8L C/TAMPA INOX ROSÉ GOLD",LYOR,Em linha,R16-B09-A01-P03,306,0,0,306
54967,7801,"PORTA MANTIMENTO 1,2L C/TAMPA INOX ROSÉ GOLD",LYOR,Em linha,R15-B06-A01-P03,198,18,0,180
54968,7800,"PORTA MANTIMENTO 1,7L C/TAMPA INOX ROSÉ GOLD",LYOR,Em linha,R15-B03-A01-P01,216,12,0,204
54970,7799,"PORTA MANTIMENTO 2,3L C/TAMPA INOX ROSÉ GOLD",LYOR,Em linha,R15-B06-A01-P01,372,12,0,360
55811,7525,POTE C/TAMPA DE ACRÍLICO GOLD ROSÉ 800 ML,LYOR,Em linha,R15-B09-A01-P01,324,0,0,324
55808,7524,"POTE C/TAMPA DE ACRÍLICO GOLD ROSÉ 1,2L",LYOR,Em linha,R15-B08-A00-P03,162,0,0,162
55809,7523,"POTE C/TAMPA DE ACRÍLICO GOLD ROSÉ 1,7L",LYOR,Em linha,R15-B07-A01-P02,156,0,0,156
55810,7522,"POTE C/TAMPA DE ACRÍLICO GOLD ROSÉ 2,2L",LYOR,Em linha,R15-B08-A01-P03,240,0,0,240
54972,7518,"POTE TRANSP 0,3L C/TAMPA DE ACRÍLICO ROSÉ GOLD",LYOR,Em linha,R15-B10-A00-P03,342,0,0,342
56161,7116,POTE HERMÉTICO C/SILICONE COLORIDO 520 ML,LYOR,Em linha,R15-B09-A01-P03,270,0,0,270
55812,1297,"POTE HERMÉTICO C/METAL PRETO 0,75L - 10 X 12,5 CM",LYOR,Em linha,R15-B09-A01-P02,612,0,0,612
55814,1295,"POTE HERMÉTICO C/METAL PRETO 1,78L - 10 X 23,5 CM",LYOR,Em linha,R15-B07-A00-P02,348,0,0,348
49991,7483,"POTICHE CORAÇÃO 8 X 6,5 X 4 CM",LYOR,Em linha,R15-B05-A00-P01,301,3,0,298
56184,7759,"POTICHE DECORATIVO PRIMA 10,5 X 13 CM",LYOR,Em linha,R15-B10-A00-P02,560,3,0,557
54983,7762,"POTICHE JAGUAR 10,8 X 14,5 CM",LYOR,Em linha,R15-B03-A00-P02,167,6,0,161
56181,7763,"POTICHE CAROUSEL G - 15,3 X 15,5 CM",LYOR,Em linha,R16-B09-A00-P03,63,6,0,57
56176,7039,"POTICHE C/PÉ LINEARIS 9,5 X 14,5 CM",LYOR,Em linha,R15-B09-A00-P02,83,3,72,80
55823,7534,"POTICHE C/PÉ DUBLIN 11,5 X 24,5 CM",LYOR,Em linha,R15-B04-A01-P03,218,14,0,204
56179,7448,"POTICHE C/PÉ SANTORINI 11,5 X 24,5 CM",LYOR,Em linha,R15-B04-A01-P02,98,5,0,93
51688,6721,PRATO P/ BOLO ANGEL 30 X 6 CM,LYOR,Em linha,R15-B10-A01-P02,34,0,0,34
54974,7757,"VASO C/PÉ DIAMOND ÂMBAR METALIZADO 14,5X11,5CM",LYOR,Em linha,R15-B08-A00-P02,109,0,0,109
56163,4371,"VASO C/PÉ DIAMOND 14,5 X 11,5 CM",LYOR,Em linha,R15-B08-A00-P01,65,2,0,63
56148,1384,"DIFUSOR C/PALITOS DUBLIN 6,5 X 11 CM",LYOR,Em linha,R16-B09-A01-P02,314,8,0,306
52607,7738,CJ C/ 3 PCS P/BANHEIRO PIERRE GOLD ROSÉ,LYOR,Em linha,R16-B09-A01-P02,195,9,0,186
56149,7422,PORTA SABONETE LÍQUIDO SORTIDO 380 ML,LYOR,Em linha,R15-B07-A01-P03,218,18,360,200
48516,SUQE-049,"GLASS - SUQUEIRA EMPIRE 4,9L",WESTERN,Em linha,R16-B03-A00-P04,23,1,10,22
48518,SUQS-012,"GLASS - SUQUEIRA SOLARIS 2,6L",WESTERN,Em linha,R16-B03-A00-P03,34,1,0,33
55782,POTE-046,GLASS - POTE HERMETICO BOJUDO 2L - Ø15 X 21CM,WESTERN,Em linha,R16-B02-A01-P01,102,6,0,96
56065,POTE-048,GLASS - POTE HERMETICO BOJUDO 600ML,WESTERN,Em linha,R16-B04-A00-P02,108,12,0,96
48514,PM3000,"GLASS - PRATO COM BORDA 2,4L - 30CM",WESTERN,Lancamento,R17-B02-A00-P01,95,6,0,89
56064,MLRA-303,HAUSKRAFT - MELEIRA BORO TAMPA INOX,WESTERN,Em linha,R16-B01-A00-P01,253,2,0,251
56071,POTE-060,HAUSKRAFT - CJ C/3 POTES 220 ML CIRCLES,WESTERN,Em linha,R16-B07-A01-P04,61,0,0,61
57044,PCON-017,HAUSKRAFT - PORTA CONDIMENTOS COLORS 120 ML,WESTERN,Lancamento,R17-B01-A02-P02,1164,12,0,1152
57042,GLHT-001,HAUSKRAFT - GALHETEIRO 4PCS,WESTERN,Lancamento,R17-B03-A00-P01,156,5,0,151
45526,SP-66,"UTIL PLAST - MOEDOR SAL E PIMENTA - 17,5 CM",WESTERN,Lancamento,R17-B03-A00-P03,345,15,0,330
57047,FXH-304,UTIL INOX - ESCOVA SANITARIA INOX,WESTERN,Lancamento,R17-B03-A02-P01,196,10,0,186
57041,ESCS-006BR,HAUSKRAFT - ESCOVA SANIT C/ BASE QUAD BRANCA,WESTERN,Lancamento,R17-B02-A00-P02,446,8,0,438
57045,PSBL-010,HAUSKRAFT - PORTA SABONETE LIQ 500ML,WESTERN,Lancamento,R17-B01-A01-P04,240,0,0,240
57046,PSBL-012,HAUSKRAFT - PORTA SABONETE LIQ 500ML RETRO,WESTERN,Lancamento,R17-B01-A01-P03,408,24,0,384
57043,PSBL-034RG,HAUSKRAFT - KIT P/ BANHEIRO 3PCS,WESTERN,Lancamento,R17-B01-A01-P01,134,13,0,121
56068,PAN05-F22VM,HAUSKRAFT - FRIGIDEIRA ALUMINIO 22CM VERMELHO,WESTERN,Em linha,R16-B06-A01-P03,71,0,0,71
56067,PAN05-F20VM,HAUSKRAFT - FRIGIDEIRA ALUMINIO 20CM VERMELHO,WESTERN,Em linha,R16-B03-A01-P03,40,0,0,40
57040,GBIN-005IN,"HAUSKRAFT - CJ BOWL C/ TPA - 0,67L + 0,9L + 1,45L",WESTERN,Lancamento,R17-B01-A02-P01,161,1,0,160
55781,ESCM-003RG,HAUSKRAFT - ESCORREDOR DE MASSA ROSE GOLD Ø24X10CM,WESTERN,Em linha,R17-B06-A02-P02,101,0,0,101
56063,ESCA-003RG,"HAUSKRAFT - ESCORREDOR ARROZ ROSE GOLD Ø25X9,7CM",WESTERN,Em linha,R17-B05-A02-P03,75,0,36,75
45531,EM-30,UTIL INOX - ESCORREDOR MASSA - Ø24 X 10 CM,WESTERN,Lancamento,R17-B01-A00-P02,410,9,0,401
57054,ER-22,"SILICONE - ESCORREDOR RETRATIL QUADRADO 28,9 CM",WESTERN,Lancamento,R17-B01-A00-P02,353,4,0,349
56517,ER-21,"SILICONE - ESCORREDOR RETRATIL REDONDO 29,9CM",WESTERN,Em linha,R17-B06-A02-P01,254,2,120,252
45566,TLAP-003,HAUSKRAFT - TELA PROTETORA 30 CM,WESTERN,Em linha,R17-B04-A00-P03,481,2,0,479
55045,A-240,UTIL INOX - ACUCAREIRO C/ PA INOX 8 X 7 CM,WESTERN,Lancamento,R17-B04-A01-P02,418,18,0,400
56074,RI-3,"UTIL INOX - RALADOR - 22 X 8,5 X 1 CM",WESTERN,Em linha,R16-B03-A01-P02,455,22,0,433
45523,RI-13,"UTIL INOX - RALADOR PRANCHA - 25,5 CM",WESTERN,Lancamento,R17-B03-A01-P03,278,12,600,266
56075,RI-8,"UTIL INOX  RALADOR 4 FACES 9 X 6,7 X 21 CM",WESTERN,Em linha,R16-B06-A01-P01,758,26,0,732
45555,EF-14,UTIL INOX - ESCUMADEIRA P/FRITURA 13 CM,WESTERN,Lancamento,R17-B01-A02-P04,738,18,0,720
45554,EF-16,UTIL INOX - ESCUMADEIRA P/FRITURA 15 CM,WESTERN,Lancamento,R17-B03-A02-P02,530,23,0,507
56085,RM-05,"UTIL PLAST - ROLO DE MASSA 38,5 X 5 CM",WESTERN,Em linha,R16-B01-A00-P01,349,5,0,344
56053,UB-06,BAMBU - CJ C/ 3 PÇS UTENSILIOS DOMESTICOS,WESTERN,Em linha,R17-B04-A02-P02,298,0,0,298
45453,1438,PRATIKA - CJ ESPATULA P/ MANTEIGA E PATE 6 PCS,WESTERN,Lancamento,R17-B04-A01-P03,384,4,0,380
57049,KC-349,SILICONE - CJ BATEDOR + ESPATULA + PINCEL,WESTERN,Lancamento,R17-B02-A02-P01,392,0,0,392
56520,KC-345,"SILICONE - CJ 4 PC PEGADOR, ESPATULA, PINCEL E FUE",WESTERN,Em linha,R17-B04-A02-P01,213,0,0,213
56073,BO-02,UTIL INOX - BATEDOR DE OVOS 26CM VERM.,WESTERN,Em linha,R16-B06-A01-P02,1708,42,0,1666
56079,FG-05,"SILICONE - FORMA GELO REDONDA 19,5 X 10,8 X 1,2 CM",WESTERN,Em linha,R16-B03-A00-P01,1656,8,0,1648
56081,GE-12,UTIL PLAST - KIT GELO ECOLOGICO C/ 12 PCS,WESTERN,Em linha,R16-B01-A01-P03,400,0,0,400
57056,PC-3,"SILICONE - CJ C/ 03 PINCEIS 17,1CM COLOR",WESTERN,Lancamento,R17-B03-A00-P02,764,0,0,764
45510,1895,"SILICONE - PINCEL - 17,5 CM",WESTERN,Em linha,R16-B08-A00-P02,1969,23,0,1946
45511,1894,SILICONE - CJ ESPATULA 19CM + PINCEL 17CM,WESTERN,Em linha,R16-B08-A00-P03,358,10,720,348
45509,1896,"SILICONE - ESPATULA - 19,5 CM",WESTERN,Em linha,R16-B04-A00-P03,994,48,0,946
45512,1893,SILICONE - ESPATULA - 23 CM,WESTERN,Em linha,R16-B06-A00-P01,1530,68,0,1462
45513,1892,SILICONE - PINCEL - 22 CM,WESTERN,Em linha,R16-B08-A00-P01,1497,61,0,1436
57052,FXH-473,SILICONE - COLHER 27CM VERMELHO,WESTERN,Lancamento,R17-B02-A01-P02,719,74,48,645
57055,FXH-474,SILICONE - ESCUMADEIRA 28CM VERMELHO,WESTERN,Lancamento,R17-B02-A01-P03,691,74,0,617
57053,FXH-475,SILICONE - CONCHA TERRINA 28CM VERMELHO,WESTERN,Lancamento,R17-B02-A01-P04,559,75,96,484
57050,FXH-480,SILICONE - CJ ESPATULA 22CM + COLHER + PINCEL 20CM,WESTERN,Lancamento,R17-B01-A00-P01,1627,0,0,1627
57051,FXH-478,SILICONE - CJ ESPATULAS 25 + 24CM + PINCEL 20CM,WESTERN,Lancamento,R17-B02-A00-P03,199,0,0,199
45463,CM-33,PRATIKA - ESPATULA P/ CORTAR E RASPAR - 15 CM,WESTERN,Em linha,R16-B04-A00-P01,216,6,0,210
45458,EC-120,PRATIKA - ESPATULA RETA - 12 CM,WESTERN,Em linha,R16-B07-A00-P04,267,9,0,258
55793,EPTL-004,HAUSKRAFT - ESPATULA RETA 10 CM,WESTERN,Em linha,R16-B05-A00-P03,489,3,0,486
55794,EPTL-005,HAUSKRAFT - ESPATULA RETA 12 CM,WESTERN,Em linha,R16-B02-A01-P02,254,25,144,229
56516,EPTL-007,"HAUSKRAFT - ESPATULA CONFEITEIRO INOX 25,5CM",WESTERN,Em linha,R16-B07-A00-P02,168,12,0,156
56521,SCRL-001PT,"HAUSKRAFT - SACA ROLHAS CLASSIC PRETO 6,5 X 3,8 CM",WESTERN,Em linha,R17-B04-A00-P01,628,9,0,619
45544,11035,UTIL INOX - SACA-ROLHAS C/ ABRIDOR DE GARRAFA-21CM,WESTERN,Em linha,R16-B01-A01-P02,381,15,0,366
45538,ABR-5,UTIL INOX - ABRIDOR LATA/GARRAFA REFORÇADO - 21CM,WESTERN,Em linha,R16-B04-A01-P02,672,42,0,630
45540,BR-01,UTIL INOX - ABRIDOR GARCOM 3X1 - 16 CM,WESTERN,Em linha,R16-B08-A01-P01,427,18,0,409
56055,EL-32,UTIL INOX - ESPREMEDOR LIMAO 20CM,WESTERN,Em linha,R16-B03-A00-P02,62,22,0,40
45536,AF-78,UTIL PLAST - AFIADOR DE FACA - 26 CM,WESTERN,Em linha,R17-B04-A02-P01,418,2,0,416
56083,IC-45,"UTIL INOX - INFUSOR DE CHA 15,5 X 4,5 X 3,5CM",WESTERN,Em linha,R17-B04-A00-P02,224,3,0,221
57057,KC-351,UTIL INOX - DESCASCADOR E RALADOR 18 X 5 X 3CM,WESTERN,Lancamento,R17-B04-A01-P01,462,12,0,450
45528,AC-15,"UTIL INOX - FURADOR / ABRIDOR DE COCO - 19,5 CM",WESTERN,Lancamento,R17-B01-A02-P03,518,13,0,505
45530,6019,UTIL INOX - MACARICO PORTATIL PRO DE ENCAIXE,WESTERN,Em linha,R16-B02-A01-P04,154,0,0,154
56072,BG-3,UTIL PLAST - BOMBA P/ GALAO DE AGUA - 9 X 17 CM,WESTERN,Em linha,R16-B05-A01-P03,588,19,0,569
56061,CJMR-002,HAUSKRAFT - COLHERES MEDIDORAS CJ 6PCS,WESTERN,Em linha,R17-B06-A02-P03,603,25,0,578
45547,RL-15,UTIL INOX - RALO P/ PIA E LAVATORIO C/ 2PCS,WESTERN,Em linha,R16-B06-A00-P03,457,8,0,449
45432,509B,"BRICO - TESOURA COSTURA 09"" - 22,5 CM",WESTERN,Em linha,R16-B05-A01-P02,457,0,0,457
55788,CJCU-003VD,HAUSKRAFT - CJ CULINARIO C/ TESOURA 3 PÇS,WESTERN,Em linha,R16-B02-A01-P03,161,0,0,161
45473,1390/3,"MADEPLAST - FACA LEGUMES 3""",WESTERN,Em linha,R16-B05-A00-P02,554,30,0,524
45469,1389/7,"MADEPLAST - FACA PAO/SERRA 7""",WESTERN,Em linha,R16-B02-A00-P03,324,0,0,324
45470,1388/6,"MADEPLAST - FACA COZINHA 6""",WESTERN,Em linha,R16-B04-A01-P03,654,18,0,636
45471,1388/7,"MADEPLAST - FACA COZINHA 7""",WESTERN,Em linha,R16-B04-A01-P01,484,8,0,476
45475,1391,MADEPLAST - CJ FACAS 4 PCS,WESTERN,Em linha,R16-B08-A01-P04,291,0,0,291
45487,5350/3,"KOCINA - FACA LEGUMES 3,5""",WESTERN,Em linha,R16-B07-A01-P01,766,17,0,749
56078,5350/6,"KOCINA - FACA PEIXEIRA 6""",WESTERN,Em linha,R16-B05-A01-P01,521,6,0,515
45481,5355/7,"KOCINA - FACA COZINHA 7""",WESTERN,Em linha,R16-B02-A00-P02,945,6,0,939
45485,5350/7,"KOCINA - FACA PEIXEIRA 7""",WESTERN,Em linha,R16-B05-A00-P01,269,0,0,269
57048,K-27,PRATIKA - CUTELO 15CM CB BRANCO,WESTERN,Lancamento,R17-B02-A01-P01,281,6,0,275
45440,1807/3,"PRATIKA - FACA PRO CB BRANCO LEGUMES 3.1/4""",WESTERN,Lancamento,R17-B03-A02-P03,659,0,0,659
45441,1800/6,"PRATIKA - FACA PRO CB BRANCO DESOSSAR 6""",WESTERN,Em linha,R16-B02-A00-P01,517,22,0,495
45444,1802/6,"PRATIKA - FACA PRO CB BRANCO COZINHA/PEIXEIRA 6""",WESTERN,Em linha,R16-B08-A01-P03,400,6,0,394
45443,1802/7,"PRATIKA - FACA PRO CB BRANCO COZINHA/PEIXEIRA 7""",WESTERN,Em linha,R16-B03-A01-P01,357,10,0,347
45442,1802/8,"PRATIKA - FACA PRO CB BRANCO COZINHA/PEIXEIRA 8""",WESTERN,Em linha,R16-B07-A00-P01,253,0,0,253
45445,1805/8,"PRATIKA - FACA PRO CB BRANCO CARNE/ACOUGUEIRO 08""",WESTERN,Em linha,R16-B06-A00-P02,331,7,0,324
45447,1805/10,"PRATIKA - FACA PRO CB BRANCO CARNE/ACOUGUEIRO 10""",WESTERN,Em linha,R16-B07-A01-P02,287,3,0,284
45446,1805/12,"PRATIKA - FACA PRO CB BRANCO CARNE/ACOUGUEIRO 12""",WESTERN,Em linha,R16-B07-A01-P03,386,3,0,383
56514,1804,"PRATIKA - CJ FACA 8"" / CHAIRA 8"" CB BRANCO",WESTERN,Em linha,R17-B05-A02-P02,154,0,0,154
56515,1806,"PRATIKA - CJ FACA 8"" / GARFO 8"" CB BRANCO",WESTERN,Em linha,R17-B05-A02-P01,104,0,0,104
55795,FCH-5008,"HAUSKRAFT - FACA CARNE COUPER 8"" - 32X4X2 CM",WESTERN,Em linha,R16-B01-A01-P01,250,7,0,243
56519,FCH-J506,"HAUSKRAFT - CJ CHURRASCO COUPER FACA 8""/ CHAIRA 8""",WESTERN,Em linha,R16-B07-A00-P03,219,0,0,219
57035,7550210BL,"CORNETA - CHAIRA 10"" CB BRANCO PREMIUM",WESTERN,Lancamento,R17-B02-A02-P02,101,2,0,99
57039,7555106BL,"CORNETA - FACA P/ DESOSSAR 6"" CB BRANCO PREMIUM",WESTERN,Lancamento,R17-B03-A01-P02,195,1,0,194
57038,7555508BL,"CORNETA - FACA P/ CARNE 8"" CB BRANCO PREMIUM",WESTERN,Lancamento,R17-B02-A02-P03,222,6,0,216
57036,7555510BL,"CORNETA - FACA P/ CARNE 10"" CB BRANCO PREMIUM",WESTERN,Lancamento,R17-B03-A01-P01,145,0,0,145
57037,7555512BL,"CORNETA - FACA P/ CARNE 12"" CB BRANCO PREMIUM",WESTERN,Lancamento,R17-B01-A01-P02,176,1,0,175
54943,4845-ASS1300,ASSADEIRA RET LUMIERE 29 X 42 X 5 CM,MIMO,Em linha,R19-B02-A02-P02,161,3,0,158
55157,4849-ASS1304,"ASSADEIRA RET LUMIERE P/PÃO 27,5 X 15,5 X 7 CM",MIMO,Em linha,R19-B01-A01-P04,160,0,0,160
56218,5001 - ASS1411,FORMA RED FUNDO REMOVÍVEL LUMIERE Ø26 X 7 CM,MIMO,Em linha,R19-B08-A02-P02,147,0,0,147
56219,5012 - ASS1417,"FORMA DE FLAN E PUDIM LUMIERE Ø24 X 7,6 CM",MIMO,Em linha,R19-B08-A01-P02,152,0,0,152
56511,7503,MODELADOR CORACAO PARA OVO INOX,MIMO,Em linha,R19-B02-A00-P06,709,12,0,697
56214,7121 - ASA20090,MODELADOR REDONDO PARA OVO INOX Ø10 CM,MIMO,Em linha,R19-B07-A02-P02,1083,29,0,1054
51932,247,ESCORREDOR MULTIUSO AÇO INOX 24 CM,MIMO,Em linha,R19-B03-A02-P01,529,8,0,521
54931,246,ESCORREDOR MULTIUSO AÇO INOX 21CM,MIMO,Em linha,R19-B02-A01-P02,335,0,0,335
52680,6285,"MANTEGUEIRA INOX C/TAMPA ACRÍLICO 6,5 X 19 X 12 CM",MIMO,Em linha,R19-B04-A00-P02,193,0,0,193
57239,6286 - AN850,"ESCORREDOR INOX C/ CABO 36,5 X 20,5 X 7 CM",MIMO,Lancamento,R18-B01-A02-P02,920,8,0,912
57238,7492 - AN2055,FUNIL PENEIRA INOX 16CM,MIMO,Lancamento,R18-B01-A01-P02,39,3,480,36
57237,7491 - AN2054,FUNIL PENEIRA INOX 14CM,MIMO,Lancamento,R18-B01-A01-P03,818,3,0,815
51953,5664,PENEIRA EM AÇO INOX 21CM,MIMO,Em linha,R19-B03-A01-P01,379,0,0,379
51952,364,PENEIRA EM ACO INOX 18 CM,MIMO,Em linha,R19-B03-A01-P02,664,0,0,664
51951,363,PENEIRA EM ACO INOX 16 CM,MIMO,Em linha,R19-B03-A01-P03,1099,8,0,1091
51950,362,PENEIRA EM ACO INOX 14 CM,MIMO,Em linha,R19-B06-A00-P03,1631,10,0,1621
51949,361,PENEIRA EM ACO INOX 10 CM,MIMO,Em linha,R19-B04-A01-P02,1476,0,0,1476
51938,3630,MIMO - FACA DE MESA,MIMO,Em linha,R19-B04-A02-P01,1908,0,0,1908
51940,3629,MIMO - GARFO DE MESA,MIMO,Em linha,R19-B05-A01-P05,2796,60,0,2736
51924,3631,MIMO - COLHER DE MESA,MIMO,Em linha,R19-B08-A01-P04,1134,0,0,1134
51939,3633,MIMO - FACA DE SOBREMESA,MIMO,Em linha,R19-B07-A01-P01,324,0,0,324
51941,3632,MIMO - GARFO DE SOBREMESA,MIMO,Em linha,R19-B07-A01-P04,180,60,240,120
51925,3634,MIMO - COLHER DE SOBREMESA,MIMO,Em linha,R19-B07-A01-P02,1513,60,0,1453
51937,3636,MIMO - FACA DE CHURRASCO,MIMO,Em linha,R19-B07-A01-P03,1464,60,0,1404
51923,3635,MIMO - COLHER DE CHA,MIMO,Em linha,R19-B06-A01-P01,840,0,0,840
51922,3881,MIMO - COLHER DE CAFE,MIMO,Em linha,R19-B06-A01-P01,696,24,0,672
51931,399,DESCASCADOR DE LEGUMES 16 CM INOX,MIMO,Promocao,R19-B04-A02-P02,240,8,0,232
57240,7161 - AQ20116,MAÇARICO CULINÁRIO PORTÁTIL,MIMO,Lancamento,R18-B01-A02-P01,334,0,0,334
51927,390,COLHER PARA SORVETE 17 CM INOX,MIMO,Promocao,R19-B06-A02-P04,1222,69,576,1153
51929,391,CORTADOR DE PIZZA 19 CM INOX,MIMO,Promocao,R19-B04-A02-P05,2036,75,0,1961
51920,412,CARRETILHA DE MASSA 17 CM INOX,MIMO,Promocao,R19-B04-A02-P04,1338,55,0,1283
52674,393,"RALADOR 17,5 CM INOX",MIMO,Em linha,R19-B06-A00-P02,960,6,0,954
51919,407,BATEDOR DE OVOS 26 CM FOUET INOX,MIMO,Em linha,R19-B07-A02-P01,6573,54,3744,6519
51947,392,PA PARA BOLO 26 CM INOX,MIMO,Promocao,R19-B03-A02-P02,375,17,360,358
57249,7293 - ASA20214,"RALADOR ZESTER 2 FACES INOX 39 X 4,5 CM ",MIMO,Lancamento,R18-B01-A01-P01,277,0,0,277
54936,6456,BATEDOR DE OVOS INOX 18 CM - FOUET INOX,MIMO,Em linha,R19-B07-A00-P04,2089,33,0,2056
51948,403,PEGADOR DE SALADA 32 CM,MIMO,Promocao,R19-B04-A02-P02,2004,27,0,1977
52671,6909,ESPATULA CULINARIA DUPLA INOX,MIMO,Em linha,R19-B06-A02-P01,270,0,0,270
52673,5752,ESPÁTULA DE INOX P/MASSAS E LEG. 17 CM,MIMO,Em linha,R19-B06-A02-P02,471,0,0,471
56512,7207,ESCOVA MULTIUSO COM CABO 30 CM,MIMO,Em linha,R19-B03-A00-P03,948,6,0,942
51928,386,CONCHA 29 CM INOX,MIMO,Em linha,R19-B08-A00-P03,411,7,0,404
51926,397,COLHER PARA ARROZ 31 CM INOX,MIMO,Em linha,R19-B08-A00-P01,795,3,0,792
51933,409,ESCUMADEIRA 32 CM AÇO INOX,MIMO,Em linha,R19-B08-A00-P02,420,7,0,413
51918,4488,AMASSADOR DE BATATAS INOX 26 CM,MIMO,Em linha,R19-B06-A00-P04,1986,18,0,1968
51942,5482,ECOKITCHEN - KIT DE UTENSÍLIOS 5 PÇS BAMBOO,MIMO,Em linha,R19-B05-A02-P02,425,2,0,423
51960,5935,ECOKITCHEN - TÁBUA GOURMET BAMBOO 36X26CM,MIMO,Em linha,R19-B05-A01-P05,556,0,0,556
51959,5934,ECOKITCHEN - TÁBUA GOURMET BAMBOO 22X32CM,MIMO,Em linha,R19-B06-A01-P03,596,0,0,596
54947,5480,ECOKITCHEN - PORTA-QUEIJO C/ TPA BAMBOO 8 X 19 CM,MIMO,Em linha,R19-B01-A01-P01,307,0,0,307
51954,6699,ECOKITCHEN - PINÇA MULTIUSO 30 CM BAMBOO,MIMO,Em linha,R19-B05-A01-P02,338,0,0,338
51921,6703,ECOKITCHEN - COLHER PARA ARROZ 29 CM BAMBOO,MIMO,Em linha,R19-B05-A01-P03,911,6,0,905
56508,7526,ECOKITCHEN - COLHER DE MESA C/ 06 PC BAMBU,MIMO,Em linha,R19-B02-A00-P01,306,8,0,298
56507,7525,ECOKITCHEN - GARFOS DE MESA C/ 06 PC BAMBU,MIMO,Em linha,R19-B03-A00-P02,380,8,0,372
56506,7534,ECOKITCHEN - FACA P/ CHURRASCO C/ 06 PC BAMBU,MIMO,Em linha,R19-B03-A00-P01,412,8,0,404
57236,7531 - ATJ05EP,ECOKITCHEN - ESPATULAS C/ 06 PC BAMBU,MIMO,Lancamento,R19-B09-A00-P02,501,3,0,498
57233,7528 - ATJ05CS,ECOKITCHEN - COLHER DE SOBREMESA C/ 06 PC BAMBU,MIMO,Lancamento,R19-B09-A00-P03,534,4,0,530
57234,7527 - ATJ05GS,ECOKITCHEN - GARFO DE SOBREMESA C/ 06 PC BAMBU,MIMO,Lancamento,R19-B09-A00-P04,390,0,0,390
57235,7535 - ATJ05FS,ECOKITCHEN - FACA DE SOBREMESA C/ 06 PC BAMBU,MIMO,Lancamento,R18-B01-A00-P02,297,0,0,297
57232,7030 - VD20138,CJ C/ 2 XÍCARAS P/ CHÁ 200 ML PAREDE DUPLA,MIMO,Lancamento,R18-B02-A02-P02,319,0,0,319
52677,6138,JG C/ 2 COPOS P/ CAFÉ 80 ML PAREDE DUPLA,MIMO,Em linha,R19-B04-A01-P03,449,8,0,441
52676,596,JG C/ 06 CANECAS P/CAFÉ 80 ML BICOLOR,MIMO,Em linha,R19-B04-A00-P03,264,2,0,262
57241,4475 - ASA1301,SILICONE - COLHER PARA ARROZ 34 CM,MIMO,Lancamento,R19-B10-A00-P01,1112,0,0,1112
57244,4476 - ASA1302,"SILICONE - CONCHA 30,5 CM",MIMO,Lancamento,R19-B10-A00-P02,1123,0,0,1123
57242,4477 - ASA1303,"SILICONE - ESCUMADEIRA 34,5 CM",MIMO,Lancamento,R19-B10-A00-P01,1153,0,0,1153
57243,4481 - ASA1305,SILICONE - ESPATULA VAZADA 35 CM,MIMO,Lancamento,R18-B02-A01-P03,1104,0,0,1104
51955,5334,SILICONE - PINCEL 26 CM INOX,MIMO,Em linha,R19-B07-A00-P01,1120,9,0,1111
51935,5335,SILICONE - ESPÁTULA PARA BOLO 26 CM INOX,MIMO,Em linha,R19-B04-A02-P03,1401,2,0,1399
51934,5336,SILICONE - ESPÁTULA 26 CM AÇO INOX,MIMO,Em linha,R19-B05-A02-P03,1162,0,0,1162
54939,2908,SILICONE - BATEDOR DE OVOS 26 CM FOUET CB INOX,MIMO,Em linha,R19-B01-A02-P01,452,4,0,448
57245,4489 - ASA1310,"SILICONE - ESPATULA C/ CABO ACRILICO 23,5 CM",MIMO,Lancamento,R18-B02-A02-P03,1871,4,0,1867
57246,4491 - ASA1312,SILICONE - ESPATULA C/ CABO ACRILICO 25 CM,MIMO,Lancamento,R18-B02-A01-P01,1903,10,0,1893
57247,4592 - ASA1315,SILICONE - PINCEL C/ CABO ACRILICO 22 CM,MIMO,Lancamento,R18-B02-A01-P02,1877,4,0,1873
57248,4593 - ASA1316,SILICONE - FUET C/ CABO ACRILICO 30 CM,MIMO,Lancamento,R18-B01-A02-P03,1914,4,0,1910
54930,6038,ESPÁTULA CONFEITARIA RETA 37 CM INOX,MIMO,Em linha,R19-B01-A01-P03,458,10,0,448
52668,6536,SILICONE - DESCANSO DE UTENSÍLIO,MIMO,Em linha,R19-B06-A02-P01,373,0,0,373
52672,5753,CJ C/ 6 PRENDEDORES DE EMBALAGENS INOX,MIMO,Em linha,R19-B04-A00-P04,593,6,0,587
51930,5709,CORTADOR FAT. DE LEGUMES ESPIRAL,MIMO,Em linha,R19-B07-A00-P03,242,3,0,239
51957,434,RALADOR PARA MESA 3 X 4 X 8 CM INOX,MIMO,Em linha,R19-B05-A01-P01,2164,24,0,2140
51956,453,RALADOR 4 FACES QUADRADO 8 X 6 X 22 CM INOX,MIMO,Em linha,R19-B05-A02-P01,3326,21,0,3305
51958,3248,SACA ROLHA 17 CM INOX,MIMO,Em linha,R19-B01-A02-P02,965,13,0,952
54946,4789,SACA ROLHA COMPACTO 12 CM INOX,MIMO,Promocao,R19-B01-A01-P03,646,6,480,640
54932,5527,INFUSOR DE INOX PARA CHÁ,MIMO,Em linha,R19-B02-A02-P01,390,4,288,386
56509,5513,XÍCARAS MEDIDORAS INOX 4 PÇS - 250/125/80/60 ML,MIMO,Em linha,R19-B02-A00-P05,192,0,0,192
56510,5517,"COLHERES MEDIDORAS INOX 4 PÇS - 15/5/2,5/1,25 ML",MIMO,Em linha,R19-B02-A00-P03,195,0,0,195
51945,3605,LUGAR AMERICANO BAMBOO MARROM 30X45 CM,MIMO,Em linha,R19-B05-A00-P02,257,9,0,248
51943,3606,LUGAR AMERICANO BAMBOO MARROM FLORAL 30X45 CM,MIMO,Em linha,R19-B05-A00-P03,275,6,0,269
51944,3607,LUGAR AMERICANO BAMBOO CRU FLORAL 30X45 CM,MIMO,Em linha,R19-B05-A00-P01,319,0,0,319
52670,6147,LUGAR AMERICANO ESTAMPA CROCHÊ PRETO 28 X 43 CM,MIMO,Em linha,R19-B04-A00-P01,1180,0,0,1180
54929,6146,LUGAR AMERICANO ESTAMPA CROCHÊ BRANCO 28 X 43 CM,MIMO,Em linha,R19-B08-A01-P01,1368,0,0,1368
56505,3609,LUGAR AMERICANO CJ C/4 BAMBU MARROM 30X45 CM,MIMO,Em linha,R19-B02-A00-P02,77,4,0,73
54934,428,TESOURA MULTIUSO 20 CM,MIMO,Em linha,R19-B02-A02-P03,328,10,0,318
54933,435,TESOURA PARA FRANGO 20 CM,MIMO,Em linha,R19-B08-A01-P03,291,13,0,278
57250,7116 - SF20076,DESFIADOR DE CARNE GARRA C/ 2 PC,MIMO,Lancamento,R18-B02-A02-P01,494,10,0,484
52678,6050,BARRA MAGNÉTICA PARA FACAS 45 CM,MIMO,Em linha,R19-B06-A00-P01,64,0,0,64
51946,6926,MANTA ANTIADERENTE P/CHURRASCO 33X40 CM,MIMO,Em linha,R19-B02-A01-P01,246,0,0,246
56513,7362,MANTA ANTIADERENTE PERFURADA 33 X 40 CM,MIMO,Em linha,R19-B02-A00-P04,291,0,0,291
52675,6847,ESCOVA P/LIMPAR GRELHA E CHURRAS 37 CM,MIMO,Em linha,R19-B03-A01-P04,1623,34,0,1589
56114,SL0841,DIAMANTE - COPO P/ REFRESCO 360 ML,ORIGINAL LINE,Em linha,R18-B09-A01-P02,396,54,0,342
56527,SL0807,CANECA 266 ML,ORIGINAL LINE,Em linha,R18-B06-A00-P03,451,0,0,451
56526,SL0805,XÍCARA PARA CHÁ 220 ML,ORIGINAL LINE,Em linha,R18-B09-A00-P02,673,0,0,673
56528,SL0808,"TIGELA RED DESENHADA Ø12,7 CM",ORIGINAL LINE,Em linha,R18-B09-A00-P01,720,66,0,654
56529,SL0809,"TIGELA RED LISA Ø12,7 CM",ORIGINAL LINE,Em linha,R18-B02-A00-P01,354,0,0,354
51639,000363,BALANÇA DIGITAL 10 KG,ORIGINAL LINE,Em linha,R18-B05-A01-P02,265,4,0,261
56089,SL0234,PROCESSADOR DE ALIMENTOS 500 ML AZUL,ORIGINAL LINE,Em linha,R17-B10-A02-P01,1104,54,3096,1050
56090,SL0235,TRITURADOR DE ALHO 170 ML,ORIGINAL LINE,Em linha,R18-B10-A01-P01,575,71,960,504
51654,000240,TÁBUA PARA CORTE 37 CM,ORIGINAL LINE,Em linha,R18-B08-A00-P01,915,53,0,862
52552,000162,ORIENTE - COLHER DE MESA,ORIGINAL LINE,Em linha,R18-B04-A00-P04,10452,312,0,10140
52550,000160,ORIENTE - GARFO DE MESA,ORIGINAL LINE,Em linha,R18-B04-A00-P05,9564,252,0,9312
52551,000161,ORIENTE - FACA DE CHURRASCO,ORIGINAL LINE,Em linha,R18-B04-A00-P06,8808,120,0,8688
51605,000201,AMERICA GARFO DE MESA,ORIGINAL LINE,Em linha,R18-B03-A00-P01,2412,300,0,2112
51610,000206,AMERICA GARFO DE SOBREMESA,ORIGINAL LINE,Em linha,R18-B05-A00-P01,912,60,0,852
51607,000203,AMERICA COLHER DE MESA,ORIGINAL LINE,Em linha,R18-B03-A00-P04,1762,432,0,1330
51608,000205,AMERICA COLHER DE SOBREMESA,ORIGINAL LINE,Em linha,R18-B03-A00-P03,2110,96,0,2014
51611,000208,AMERICA COLHER DE CHA,ORIGINAL LINE,Em linha,R18-B04-A00-P02,1020,108,0,912
51609,000204,AMERICA FACA DE MESA,ORIGINAL LINE,Em linha,R18-B04-A00-P03,804,96,0,708
51606,000202,AMERICA FACA DE CHURRASCO,ORIGINAL LINE,Em linha,R18-B03-A00-P02,2472,84,0,2388
51612,000207,AMERICA FACA DE SOBREMESA,ORIGINAL LINE,Em linha,R18-B05-A00-P02,432,12,0,420
51623,000296,PENEIRA INOX 20 CM,ORIGINAL LINE,Em linha,R17-B10-A02-P02,1059,42,0,1017
51625,000295,PENEIRA INOX 18 CM,ORIGINAL LINE,Em linha,R18-B04-A02-P02,1151,51,0,1100
51624,000294,PENEIRA INOX 16 CM,ORIGINAL LINE,Em linha,R18-B08-A02-P01,1134,73,0,1061
51626,000293,PENEIRA INOX 14 CM,ORIGINAL LINE,Em linha,R18-B01-A00-P02,1423,66,0,1357
51627,000292,PENEIRA INOX 12 CM,ORIGINAL LINE,Em linha,R18-B05-A01-P01,1181,57,0,1124
56109,SL0551,COOK - DESCASCADOR DE LEGUMES 21 CM,ORIGINAL LINE,Em linha,R18-B09-A02-P02,412,9,0,403
56105,SL0540,COOK - CONCHA 37 CM,ORIGINAL LINE,Em linha,R18-B10-A01-P02,366,25,0,341
56107,SL0542,COOK - ESCUMADEIRA 37 CM,ORIGINAL LINE,Em linha,R18-B10-A00-P02,366,24,0,342
56108,SL0547,COOK - ESCUMADEIRA P/ FRITURA 38 CM,ORIGINAL LINE,Em linha,R18-B10-A02-P01,534,25,0,509
56110,SL0553,"COOK  - BATEDOR DE CLARA 28,5 CM",ORIGINAL LINE,Em linha,R18-B09-A02-P03,702,31,0,671
56525,SL0619,BATEDOR DE CLARAS SILICONE 30 X 7 CM,ORIGINAL LINE,Em linha,R18-B07-A02-P02,1433,9,0,1424
51641,000523,PEGADOR DE MASSA 20 CM,ORIGINAL LINE,Em linha,R17-B09-A02-P01,469,57,0,412
51644,000525,PEGADOR UNIVERSAL 20 CM,ORIGINAL LINE,Em linha,R18-B07-A02-P01,220,6,0,214
51640,000520,PEGADOR DE MASSA 29 CM,ORIGINAL LINE,Em linha,R18-B03-A02-P03,87,20,180,67
51658,000211,"AMERICA CONCHA 22,7 CM",ORIGINAL LINE,Em linha,R18-B04-A00-P01,492,11,0,481
51656,000212,"AMERICA COLHER DE ARROZ 24,5 CM",ORIGINAL LINE,Em linha,R18-B07-A01-P03,1667,464,0,1203
51659,000219,"AMERICA ESCUMADEIRA 26,5 CM",ORIGINAL LINE,Em linha,R18-B05-A00-P03,1935,432,0,1503
51660,000640,BAMBU COLHER 29 CM,ORIGINAL LINE,Em linha,R18-B04-A01-P03,767,30,0,737
51661,000641,BAMBU ESPATULA 30 CM,ORIGINAL LINE,Em linha,R18-B03-A01-P01,371,12,0,359
56093,SL0372,BALANÇA PARA BANHEIRO 180 KGS,ORIGINAL LINE,Em linha,R18-B09-A01-P01,77,2,0,75
51621,000230,RALADOR 1 FACE 29 CM,ORIGINAL LINE,Em linha,R18-B07-A01-P01,167,34,540,133
51619,000224,RALADOR 4 FACES 24 CM,ORIGINAL LINE,Em linha,R18-B03-A01-P02,2678,67,0,2611
56094,SL0381,AFIADOR DE FACAS SLIM,ORIGINAL LINE,Em linha,R18-B09-A00-P01,240,2,0,238
56095,SL0392,CORTADOR DE PIZZA 21 CM,ORIGINAL LINE,Em linha,R18-B07-A00-P01,274,12,0,262
56096,SL0396,MISTURADOR DE BEBIDAS,ORIGINAL LINE,Em linha,R18-B09-A02-P01,670,82,360,588
51662,000503,COLHER P/ SUCO 30 CM,ORIGINAL LINE,Em linha,R18-B04-A01-P04,1200,6,0,1194
51646,000359,ESPREMEDOR DE ALHO SLIM,ORIGINAL LINE,Em linha,R18-B08-A02-P03,219,0,0,219
51630,000273,ABRIDOR DE LATAS/GARRAFAS SARDINHA C/ CART,ORIGINAL LINE,Em linha,R18-B06-A02-P01,1495,74,0,1421
51632,000275,ABRIDOR DE GARRAFAS BOTECO C/CART,ORIGINAL LINE,Em linha,R18-B08-A01-P03,1548,46,0,1502
56524,SL0361,"RALINHO G 3/2""",ORIGINAL LINE,Em linha,R18-B07-A01-P02,1665,85,0,1580
56523,SL0360,"RALINHO P 1/2""",ORIGINAL LINE,Em linha,R18-B05-A02-P02,1379,57,0,1322
52557,000735,RALINHO P/ PIA INOX 11.5 CM,ORIGINAL LINE,Em linha,R18-B01-A00-P01,1059,51,0,1008
51628,000734,RALINHO P/ PIA INOX 9 CM,ORIGINAL LINE,Em linha,R18-B08-A01-P02,3148,196,0,2952
51629,000733,"RALINHO P/ PIA INOX 7,2 CM",ORIGINAL LINE,Em linha,R18-B05-A01-P03,1634,122,0,1512
52556,000732,RALINHO P/ PIA INOX 5.4 CM,ORIGINAL LINE,Em linha,R18-B07-A01-P04,1002,47,0,955
51650,000350,"ESPATULA CURVA 6,3 CM",ORIGINAL LINE,Em linha,R18-B04-A02-P02,372,21,0,351
51649,000352,ESPATULA RETA 10 CM,ORIGINAL LINE,Em linha,R18-B07-A00-P03,337,10,0,327
51613,000446,KIT CHURRASCO DESIGN 3 PCS,ORIGINAL LINE,Em linha,R18-B03-A02-P02,387,4,0,383
56097,SL0447,"KIT C/ 2 PÇS P/ CHURRASCO - FACA 7"" + GARFO 5""",ORIGINAL LINE,Em linha,R18-B10-A02-P03,217,6,0,211
56092,SL0338,"CUTELO PEIXEIRA 6""",ORIGINAL LINE,Em linha,R18-B06-A00-P02,346,4,0,342
56091,SL0329,"FACA PEIXEIRA LEGUMES E VERDURAS 5""",ORIGINAL LINE,Em linha,R18-B06-A00-P01,366,11,0,355
51617,000440,"FACA DESIGN 3"" - 7,6 CM",ORIGINAL LINE,Em linha,R18-B08-A02-P03,275,16,0,259
51615,000442,"FACA DESIGN 6"" - 15,2 CM",ORIGINAL LINE,Em linha,R18-B03-A02-P01,1073,0,0,1073
51614,000443,"FACA DESIGN 7"" - 18 CM",ORIGINAL LINE,Em linha,R18-B04-A02-P01,1178,2,0,1176
51616,000444,"FACA DESIGN 8"" - 20 CM",ORIGINAL LINE,Em linha,R17-B10-A02-P03,624,2,0,622
51635,000087,TESOURA 21 CM USO GERAL,ORIGINAL LINE,Em linha,R18-B06-A02-P03,1953,453,0,1500
51637,000084,TESOURA 19 CM P/CABELO,ORIGINAL LINE,Em linha,R18-B07-A00-P02,973,50,0,923
51636,000086,TESOURA 19 CM USO GERAL,ORIGINAL LINE,Em linha,R18-B08-A00-P02,517,66,360,451
51638,000088,TESOURA 23 CM USO GERAL,ORIGINAL LINE,Em linha,R18-B06-A02-P02,1082,43,0,1039
51634,000082,TESOURAS CJ C/ 03 - 14CM + CABELO 19CM + 24 CM,ORIGINAL LINE,Em linha,R18-B02-A00-P02,309,6,0,303
55986,143.675.9008.701,SINTONIA GLITTER AZUL - CX COMBO 175 PC ,SIMONAGGIO,Em linha,R21-B06-A01-P02,145,0,0,145
55987,143.106.0101.701,SINTONIA GLITTER AZUL- COLHER MESA C/06 PC  ,SIMONAGGIO,Em linha,R21-B06-A00-P01,541,6,0,535
55988,143.106.0201.701,SINTONIA GLITTER AZUL- GARFO MESA C/06 PC,SIMONAGGIO,Em linha,R21-B06-A00-P03,659,0,0,659
55989,143.106.0301.701,SINTONIA GLITTER AZUL- FACA CARNE C/ 06 PC  ,SIMONAGGIO,Em linha,R21-B06-A00-P02,695,0,0,695
55982,143.675.9008.700,SINTONIA GLITTER VERMELHO- CX COMBO 175 PC ,SIMONAGGIO,Em linha,R21-B06-A01-P01,57,0,0,57
55983,143.106.0101.700,SINTONIA GLITTER VERMELHO- COLHER MESA C/06 PC  ,SIMONAGGIO,Em linha,R21-B05-A00-P02,204,15,0,189
55984,143.106.0201.700,SINTONIA GLITTER VERMELHO- GARFO MESA C/06 PC,SIMONAGGIO,Em linha,R21-B05-A00-P01,318,9,0,309
55985,143.106.0301.700,SINTONIA GLITTER VERMELHO- FACA CARNE C/ 06 PC  ,SIMONAGGIO,Em linha,R21-B05-A00-P03,308,7,0,301
54993,121.675.9008.002 ,SINTONIA PRETO - CX COMBO 175 PC,SIMONAGGIO,Em linha,R21-B01-A01-P04,204,2,0,202
48421,121.608.9008.002,SINTONIA PRETO - CX COMBO 80 PC ,SIMONAGGIO,Em linha,R20-B02-A01-P02,38,0,0,38
54994,121.106.0101.002 ,SINTONIA PRETO - COLHER MESA C/06 PC,SIMONAGGIO,Em linha,R21-B02-A00-P03,688,32,0,656
35836,121.106.0201.002 ,SINTONIA PRETO - GARFO MESA C/06 PC ,SIMONAGGIO,Em linha,R22-B08-A01-P03,1015,35,0,980
54996,121.106.0301.002 ,SINTONIA PRETO - FACA CARNE C/ 06 PC,SIMONAGGIO,Em linha,R21-B07-A02-P03,1234,37,0,1197
54989,121.675.9008.007,SINTONIA VERMELHO - CX COMBO 175 PC,SIMONAGGIO,Em linha,R21-B02-A01-P02,93,0,0,93
49896,121.608.9008.007,SINTONIA VERMELHO  - CX COMBO 80 PC ,SIMONAGGIO,Em linha,R21-B06-A01-P04,38,0,0,38
54990,121.106.0101.007,SINTONIA VERMELHO - COLHER MESA C/06 PC,SIMONAGGIO,Em linha,R21-B07-A01-P04,507,6,0,501
49894,121.106.0201.007 ,SINTONIA VERMELHO - GARFO MESA C/06 PC  ,SIMONAGGIO,Em linha,R22-B05-A02-P04,499,0,0,499
54992,121.106.0301.007,SINTONIA VERMELHO - FACA CARNE C/ 06 PC,SIMONAGGIO,Em linha,R22-B09-A00-P04,711,3,0,708
55001,121.675.9008.018 || CS-18/175,SINTONIA ROSA - CX COMBO 175 PC,SIMONAGGIO,Em linha,R21-B04-A01-P04,68,1,0,67
55002,121.106.0101.018 ,SINTONIA ROSA - COLHER MESA C/06 PC,SIMONAGGIO,Em linha,R21-B03-A00-P03,253,6,300,247
45635,121.106.0201.018 || LS1302/06-18,SINTONIA ROSA - GARFO MESA C/06 PC  ,SIMONAGGIO,Em linha,R21-B09-A02-P04,153,6,300,147
55004,121.106.0301.018,SINTONIA ROSA - FACA CARNE C/06 PC,SIMONAGGIO,Em linha,R21-B02-A00-P01,220,6,300,214
54997,121.675.9008.011 || CS-11/175,SINTONIA AMARELO - CX COMBO 175 PC,SIMONAGGIO,Em linha,R21-B02-A01-P01,90,1,0,89
48425,121.608.9008.011 || CS-11/80,SINTONIA AMARELO - CX COMBO 80 PC ,SIMONAGGIO,Em linha,R22-B09-A02-P02,28,0,0,28
54998,121.106.0101.011,SINTONIA AMARELO - COLHER MESA C/06 PC,SIMONAGGIO,Em linha,R21-B02-A00-P02,134,16,300,118
35840,121.106.0201.011,SINTONIA AMARELO - GARFO MESA C/06 PC ,SIMONAGGIO,Em linha,R22-B08-A01-P04,128,10,300,118
55000,121.106.0301.011,SINTONIA AMARELO - FACA CARNE C/06 PC,SIMONAGGIO,Em linha,R21-B02-A02-P03,378,10,300,368
55005,121.675.9008.014,SINTONIA AZUL - CX COMBO 175 PC,SIMONAGGIO,Em linha,R21-B05-A01-P03,105,0,0,105
55006,121.106.0101.014,SINTONIA AZUL - COLHER MESA C/06 PC,SIMONAGGIO,Em linha,R21-B02-A02-P04,457,0,0,457
35843,121.106.0201.014,SINTONIA AZUL - GARFO MESA C/06 PC  ,SIMONAGGIO,Em linha,R22-B08-A00-P01,368,6,0,362
55007,121.106.0301.014 ,SINTONIA AZUL - FACA CARNE C/06 PC,SIMONAGGIO,Em linha,R22-B03-A02-P02,543,6,0,537
55008,121.675.9008.001 || CS-01/175,SINTONIA BRANCO - CX COMBO 175 PC,SIMONAGGIO,Em linha,R21-B04-A01-P01,121,0,0,121
48422,121.608.9008.001 || CS-01/80,SINTONIA BRANCO - CX COMBO 80 PC ,SIMONAGGIO,Em linha,R22-B09-A02-P01,41,0,0,41
55010,121.106.0101.001 ,SINTONIA BRANCO - COLHER MESA C/06 PC,SIMONAGGIO,Em linha,R21-B03-A00-P01,486,16,0,470
35833,121.106.0201.001 || LS1302/06-01,SINTONIA BRANCO - GARFO MESA C/06 PC  ,SIMONAGGIO,Em linha,R22-B08-A01-P02,327,10,0,317
55009,121.106.0301.001,SINTONIA BRANCO - FACA CARNE C/ 06 PC,SIMONAGGIO,Em linha,R22-B08-A00-P04,426,10,0,416
45632,161.675.9008.018,SINTONIA ROSA PROVENÇAL - CX COMBO 175 PC,SIMONAGGIO,Em linha,R21-B05-A01-P02,179,1,0,178
45634,161.106.0101.018,SINTONIA ROSA PROVENÇAL - COLHER MESA C/06 PC ,SIMONAGGIO,Em linha,R21-B09-A02-P01,937,3,0,934
55003,161.106.0201.018 ,SINTONIA ROSA PROVENÇAL - GARFO MESA C/06 PC,SIMONAGGIO,Em linha,R21-B09-A02-P02,899,14,0,885
45636,161.106.0301.018,SINTONIA ROSA PROVENÇAL - FACA CARNE C/06 PC,SIMONAGGIO,Em linha,R21-B09-A02-P03,1063,14,0,1049
35828,161.675.9008.002,SINTONIA PRETO LABIRINTO - CX COMBO 175 PC,SIMONAGGIO,Em linha,R21-B04-A01-P02,172,0,0,172
35835,161.106.0101.002 ,SINTONIA PRETO LABIRINTO - COLHER MESA C/06 PC ,SIMONAGGIO,Em linha,R21-B03-A00-P02,787,28,0,759
54995,161.106.0201.002,SINTONIA PRETO LABIRINTO - GARFO MESA C/06 PC,SIMONAGGIO,Em linha,R22-B04-A02-P02,634,29,0,605
35837,161.106.0301.002,SINTONIA PRETO LABIRINTO - FACA CARNE C/ 06 PC  ,SIMONAGGIO,Em linha,R21-B09-A01-P04,1319,33,0,1286
49892,161.675.9008.007,SINTONIA VERMELHO COLMEIA  - CX COMBO 175 PC ,SIMONAGGIO,Em linha,R21-B04-A01-P05,144,1,0,143
49895,161.106.0101.007,SINTONIA VERMELHO COLMEIA - COLHER MESA C/06 PC  ,SIMONAGGIO,Em linha,R22-B07-A01-P01,353,0,0,353
54991,161.106.0201.007 || 1302/06-07CL,SINTONIA VERMELHO COLMEIA - GARFO MESA C/06 PC,SIMONAGGIO,Em linha,R22-B07-A01-P02,230,0,0,230
49893,161.106.0301.007 || 1303/06-07CL,SINTONIA VERMELHO COLMEIA - FACA CARNE C/ 06 PC  ,SIMONAGGIO,Em linha,R22-B07-A01-P03,259,0,0,259
56282,161.675.9008.011,SINTONIA AMARELO TRANÇADO - CX COMBO 175 PC,SIMONAGGIO,Em linha,R21-B06-A01-P03,157,1,0,156
56280,161.106.0101.011,SINTONIA AMARELO TRANÇADO - COLHER MESA C/06 PC,SIMONAGGIO,Em linha,R21-B08-A01-P01,384,2,0,382
54999,161.106.0201.011 || 1302/06-11TR,SINTONIA AMARELO TRANÇADO - GARFO MESA C/06 PC,SIMONAGGIO,Em linha,R22-B08-A00-P05,720,0,0,720
56281,161.106.0301.011,SINTONIA AMARELO TRANÇADO - FACA CARNE C/06 PC,SIMONAGGIO,Em linha,R21-B04-A00-P02,343,0,0,343
57072,142.675.9008.112,SINTONIA ESMERALDA - CX COMBO 175 PC,SIMONAGGIO,Lancamento,R21-B07-A01-P03,145,0,0,145
57076,142.608.9008.112,SINTONIA ESMERALDA - CX COMBO 80 PC,SIMONAGGIO,Lancamento,R21-B05-A02-P04,26,0,0,26
57075,142.106.0101.112,SINTONIA ESMERALDA - COLHER MESA C/06 PCS,SIMONAGGIO,Lancamento,R21-B09-A00-P03,624,15,0,609
57074,142.106.0201.112,SINTONIA ESMERALDA - GARFO DE MESA C/06 PCS,SIMONAGGIO,Lancamento,R21-B09-A00-P02,752,9,0,743
57073,142.106.0301.112,SINTONIA ESMERALDA - FACA DE MESA C/06 PCS,SIMONAGGIO,Lancamento,R21-B09-A00-P01,886,7,0,879
38126,142.675.9008.102,SINTONIA MOGNO - CX COMBO 175 PC,SIMONAGGIO,Em linha,R21-B03-A01-P04,135,0,0,135
48424,142.608.9008.102,SINTONIA MOGNO - CX COMBO 80 PC,SIMONAGGIO,Em linha,R20-B02-A01-P03,43,0,0,43
38122,142.106.0101.102 ,SINTONIA MOGNO - COLHER MESA C/06 PCS,SIMONAGGIO,Em linha,R22-B04-A02-P03,1144,17,0,1127
38142,142.106.0201.102,SINTONIA MOGNO - GARFO DE MESA C/06 PCS,SIMONAGGIO,Em linha,R21-B01-A02-P03,1960,22,0,1938
38135,142.106.0301.102 ,SINTONIA MOGNO - FACA DE MESA C/06 PCS,SIMONAGGIO,Em linha,R21-B01-A02-P01,2060,11,0,2049
39713,142.675.9008.105,SINTONIA TRAVERTINO - CX COMBO 175 PC,SIMONAGGIO,Em linha,R21-B02-A01-P04,150,0,0,150
48423,142.608.9008.105,SINTONIA TRAVERTINO - CX COMBO 80 PC,SIMONAGGIO,Em linha,R20-B02-A01-P04,29,0,0,29
39714,142.106.0101.105,SINTONIA TRAVERTINO - COLHER MESA C/06 PCS,SIMONAGGIO,Em linha,R22-B06-A00-P01,789,5,0,784
39715,142.106.0201.105 ,SINTONIA TRAVERTINO - GARFO MESA C/06 PCS,SIMONAGGIO,Em linha,R22-B04-A02-P04,1000,18,0,982
39716,142.106.0301.105 ,SINTONIA TRAVERTINO - FACA DE MESA C/06 PCS,SIMONAGGIO,Em linha,R21-B01-A02-P02,1080,18,0,1062
48427,142.675.9008.106,SINTONIA MADREPÉROLA - CX COMBO 175 PC,SIMONAGGIO,Em linha,R21-B01-A01-P02,153,0,0,153
48431,142.608.9008.106,SINTONIA MADREPÉROLA - CX COMBO 80 PC,SIMONAGGIO,Em linha,R21-B05-A01-P01,32,0,0,32
48430,142.106.0101.106,SINTONIA MADREPÉROLA - COLHER MESA C/06 PCS,SIMONAGGIO,Em linha,R22-B05-A00-P01,889,5,0,884
48429,142.106.0201.106 ,SINTONIA MADREPÉROLA - GARFO DE MESA C/06 PCS,SIMONAGGIO,Em linha,R22-B05-A00-P02,1295,15,0,1280
48428,142.106.0301.106,SINTONIA MADREPÉROLA - FACA DE MESA C/06 PCS,SIMONAGGIO,Em linha,R22-B05-A00-P03,1147,21,0,1126
57285,CD/175-CM,SINTONIA BEGE COMPOSE - CX COMBO 175 PC,SIMONAGGIO,Lancamento,,50,0,0,50
57293,CD-02/175DS,SINTONIA PRETO DEC - CX COMBO 175 PC,SIMONAGGIO,Lancamento,,50,0,0,50
57296,CD-05/175DS,SINTONIA VERDE DEC - CX COMBO 175 PC,SIMONAGGIO,Lancamento,,30,0,20,30
57289,CD-11/175DS,SINTONIA AMARELO DEC - CX COMBO 175 PC,SIMONAGGIO,Lancamento,,50,0,0,50
57290,CD-14/175DS,SINTONIA AZUL DEC - CX COMBO 175 PC,SIMONAGGIO,Lancamento,,50,0,0,50
57292,CD-01/175DS,SINTONIA BRANCO DEC - CX COMBO 175 PC,SIMONAGGIO,Lancamento,,50,0,0,50
57295,CD-07/175DS,SINTONIA VERMELHO DEC - CX COMBO 175 PC,SIMONAGGIO,Lancamento,,36,0,14,36
57077,140.675.9008.001,RATTAN CREME - CX COMBO 175 PC,SIMONAGGIO,Lancamento,R21-B07-A01-P02,204,0,0,204
57078,140.106.0101.001,RATTAN CREME - COLHER MESA C/06 PC,SIMONAGGIO,Lancamento,R21-B10-A00-P01,711,6,0,705
57079,140.106.0201.001,RATTAN CREME - GARFO MESA C/06 PC,SIMONAGGIO,Lancamento,R21-B10-A00-P02,852,0,0,852
57080,140.106.0301.001,RATTAN CREME - FACA CARNE C/ 06 PC,SIMONAGGIO,Lancamento,R21-B10-A00-P03,977,0,0,977
57082,140.106.9022.001,RATTAN CREME - CJ SOBREMESA C/ 06 PC,SIMONAGGIO,Lancamento,R20-B02-A02-P01,778,12,0,766
57085,140.675.9008.020,RATTAN TERRACOTA - CX COMBO 175 PC,SIMONAGGIO,Lancamento,R21-B07-A01-P01,167,0,0,167
57086,140.106.0101.020,RATTAN TERRACOTA - COLHER MESA C/06 PC,SIMONAGGIO,Lancamento,R20-B01-A01-P01,526,6,0,520
57087,140.106.0201.020,RATTAN TERRACOTA - GARFO MESA C/06 PC,SIMONAGGIO,Lancamento,R20-B01-A01-P02,647,6,0,641
57088,140.106.0301.020,RATTAN TERRACOTA - FACA CARNE C/ 06 PC,SIMONAGGIO,Lancamento,R20-B01-A01-P03,779,6,0,773
57089,140.106.9022.020,RATTAN TERRACOTA - CJ SOBREMESA C/ 06 PC,SIMONAGGIO,Lancamento,R20-B02-A02-P02,659,12,0,647
55015,140.675.9008.019,RATTAN MARROM - CX COMBO 175 PC,SIMONAGGIO,Em linha,R21-B05-A01-P05,205,2,0,203
55017,140.106.0101.019,RATTAN MARROM - COLHER MESA C/06 PC,SIMONAGGIO,Em linha,R21-B02-A02-P02,297,4,0,293
55018,140.106.0201.019,RATTAN MARROM - GARFO MESA C/06 PC,SIMONAGGIO,Em linha,R22-B03-A02-P03,671,4,0,667
55016,140.106.0301.019,RATTAN MARROM - FACA CARNE C/ 06 PC,SIMONAGGIO,Em linha,R21-B09-A01-P03,954,4,0,950
57081,140.106.9022.019,RATTAN MARROM - CJ SOBREMESA C/ 06 PC,SIMONAGGIO,Lancamento,R20-B02-A02-P03,679,12,0,667
33192,310.614.9004.400,CUCINA MIA - CAIXA COMBO 144 PCS ,SIMONAGGIO,Em linha,R21-B02-A01-P03,113,2,0,111
4329,310.103.0101.400 ,CUCINA MIA COLHER MESA CABO MADEIRA C/3 PCS,SIMONAGGIO,Em linha,R22-B06-A00-P02,2120,18,0,2102
4330,310.103.0201.400 ,CUCINA MIA GARFO MESA CABO MADEIRA C/3 PCS,SIMONAGGIO,Em linha,R22-B06-A00-P03,2156,30,0,2126
4331,310.103.0301.400,CUCINA MIA FACA MESA CABO MADEIRA C/3 PCS,SIMONAGGIO,Em linha,R22-B06-A00-P04,3707,36,0,3671
38124,101.694.9008.013 || CB-47/230,BELIZE - CAIXA COMBO 230 PCS CB TIFANNY,SIMONAGGIO,Em linha,R21-B03-A01-P01,21,0,0,21
38119,101.106.0101.002,BELIZE COLHER DE MESA-6PCS-PRETO,SIMONAGGIO,Em linha,R22-B04-A02-P01,699,22,0,677
38139,101.106.0201.002 ,BELIZE GARFO DE MESA-6PCS-PRETO,SIMONAGGIO,Em linha,R22-B06-A02-P03,514,40,0,474
38132,101.106.0301.002 ,BELIZE FACA DE MESA-6PCS-PRETO,SIMONAGGIO,Em linha,R22-B05-A02-P02,677,40,0,637
38118,101.106.0101.013 || 4721/6,BELIZE COLHER DE MESA-6PCS-TIFANNY,SIMONAGGIO,Em linha,R22-B05-A02-P01,265,5,0,260
38138,101.106.0201.013 || 4722/6,BELIZE GARFO DE MESA-6PCS-TIFANNY,SIMONAGGIO,Em linha,R21-B02-A00-P04,555,11,0,544
38130,101.106.0301.013 || 4724/6,BELIZE FACA DE MESA-6PCS-TIFANNY,SIMONAGGIO,Em linha,R22-B06-A02-P04,465,11,0,454
38120,101.106.0101.007,BELIZE COLHER DE MESA-6PCS-VERMELHO ,SIMONAGGIO,Em linha,R22-B05-A02-P03,237,11,0,226
38140,101.106.0201.007,BELIZE GARFO DE MESA-6PCS-VERMELHO,SIMONAGGIO,Em linha,R22-B06-A02-P01,233,23,0,210
38133,101.106.0301.007,BELIZE FACA DE MESA-6PCS-VERMELHO,SIMONAGGIO,Em linha,R22-B06-A02-P02,221,23,0,198
49908,100.697.9004.007 ,TREVISO - CX COMBO 260PCS VERMELHO,SIMONAGGIO,Em linha,R21-B01-A01-P01,61,1,0,60
49906,100.324.9008.007,TREVISO - FAQUEIRO 24 PCS CABO VERMELHO,SIMONAGGIO,Em linha,R22-B09-A02-P03,101,3,0,98
49913,100.103.0101.007,TREVISO - COLHER MESA C/ 03 PCS CABO VERMELHO,SIMONAGGIO,Promocao,R22-B10-A01-P05,1475,44,0,1431
49917,100.103.0201.007,TREVISO - GARFO MESA C/ 03 PCS CABO VERMELHO,SIMONAGGIO,Promocao,R22-B09-A01-P04,775,30,0,745
49914,100.103.0301.007 ,TREVISO - FACA MESA C/ 03 PCS CABO VERMELHO,SIMONAGGIO,Promocao,R22-B09-A01-P03,1039,44,0,995
49907,100.697.9004.002 ,TREVISO - CX COMBO 260PCS PRETO,SIMONAGGIO,Em linha,R21-B03-A01-P03,61,2,0,59
49904,100.324.9008.002 ,TREVISO - FAQUEIRO 24 PCS CABO PRETO,SIMONAGGIO,Em linha,R22-B10-A02-P01,103,0,0,103
49911,100.103.0101.002 ,TREVISO - COLHER MESA C/ 03 PCS CABO PRETO,SIMONAGGIO,Promocao,R22-B09-A01-P01,3295,85,0,3210
49912,100.103.0201.002,TREVISO - GARFO MESA C/ 03 PCS CABO PRETO,SIMONAGGIO,Promocao,R22-B09-A01-P02,1742,49,0,1693
49910,100.103.0301.002 ,TREVISO - FACA MESA C/ 03 PCS CABO PRETO,SIMONAGGIO,Promocao,R22-B08-A01-P01,2003,67,0,1936
4327,200.103.0101.300,MONIZ COLHER MESA C/3 PCS.CART,SIMONAGGIO,Em linha,R21-B10-A01-P01,2611,54,0,2557
4328,200.103.0201.300 ,MONIZ GARFO MESA C/3 PCS.CART,SIMONAGGIO,Em linha,R21-B10-A01-P02,2633,24,0,2609
17655,200.103.0304.300,MONIZ FACA CHURRASCO C/03 PCS,SIMONAGGIO,Em linha,R22-B09-A01-P05,1069,6,0,1063
17657,200.103.0305.300 ,MONIZ FACA MESA C/ 3 PCS,SIMONAGGIO,Em linha,R22-B07-A01-P04,360,6,0,354
15449,200.103.0102.300 ,MONIZ COLHER SOBREMESA C/03 PCS ,SIMONAGGIO,Em linha,R22-B08-A00-P03,1949,6,0,1943
15452,250.103.0403.300 ,MONIZ COLHER SUCO C/03 PCS,SIMONAGGIO,Em linha,R20-B01-A02-P01,1491,55,0,1436
5221,200.106.0104.300 ,MONIZ COLHER P/ CHA 06 PCS,SIMONAGGIO,Em linha,R22-B08-A00-P02,1289,51,0,1238
5047,200.106.0105.300 ,MONIZ COLHER P/ CAFE 06 PCS,SIMONAGGIO,Em linha,R21-B10-A02-P02,1401,66,0,1335
5042,200.572.0101.300,MONIZ COLHER MESA - DUZIA,SIMONAGGIO,Em linha,R21-B05-A00-P04,779,22,0,757
5043,200.572.0201.300,MONIZ GARFO MESA - DUZIA,SIMONAGGIO,Em linha,R21-B06-A00-P05,379,0,0,379
17654,200.572.0304.300 ,MONIZ FACA CHURRASCO - DUZIA,SIMONAGGIO,Em linha,R21-B04-A00-P05,52,0,0,52
22399,250.101.0425.300,MONIZ ABRIDOR DE LATAS E GARRAFAS,SIMONAGGIO,Em linha,R21-B03-A02-P01,4280,106,0,4174
7421,250.441.0415.300 ,MONIZ PEGADOR UNIVERSAL,SIMONAGGIO,Em linha,R22-B08-A02-P04,1069,17,0,1052
11621,250.441.0414.300,MONIZ PEGADOR MULTIUSO,SIMONAGGIO,Em linha,R22-B07-A02-P04,811,82,0,729
7419,250.441.0416.300 ,MONIZ PEGADOR DE SALADA,SIMONAGGIO,Em linha,R22-B08-A02-P03,2093,23,0,2070
7420,250.441.0417.300 ,MONIZ PEGADOR DE MASSA,SIMONAGGIO,Em linha,R22-B08-A02-P02,3435,65,0,3370
22400,250.441.0413.300 ,MONIZ PEGADOR DE FRITURAS,SIMONAGGIO,Em linha,R22-B07-A02-P03,550,18,0,532
15454,250.441.0402.300,MONIZ COLHER BAILARINA ENCARTELADA,SIMONAGGIO,Promocao,R22-B10-A01-P01,930,34,0,896
7425,250.441.0421.300 ,MONIZ PA PARA BOLO,SIMONAGGIO,Em linha,R22-B06-A01-P01,5173,112,0,5061
5104,250.441.0408.300,MONIZ GARFO P/ASSADOS,SIMONAGGIO,Promocao,R22-B10-A01-P03,2104,51,0,2053
3937,250.441.0412.300 ,MONIZ ESCUMADEIRA,SIMONAGGIO,Em linha,R22-B06-A01-P02,5935,165,0,5770
3938,250.441.0400.300 ,MONIZ COLHER P/ARROZ ,SIMONAGGIO,Promocao,R22-B06-A01-P03,8163,157,0,8006
3936,250.441.0411.300,MONIZ CONCHA,SIMONAGGIO,Em linha,R22-B10-A01-P02,4803,84,0,4719
36954,250.441.0419.300 ,MONIZ PEGADOR P/ MASSA CABO LONGO 29CM,SIMONAGGIO,Em linha,R21-B09-A01-P02,617,12,0,605
36955,250.441.0418.300 ,"MONIZ PEGADOR P/ SALADA CABO LONGO 28,8CM",SIMONAGGIO,Em linha,R21-B09-A01-P01,540,12,0,528
38129,200.324.9009.300,MONIZ FAQUEIRO 24PCS,SIMONAGGIO,Em linha,R22-B10-A02-P02,154,0,0,154
28733,260.441.0411.300 ,ARUBA - CONCHA ACO INOX 26 CM,SIMONAGGIO,Em linha,R22-B08-A02-P01,1203,459,880,744
36956,260.441.0401.300 ,"ARUBA - COLHER P/ SERVIR 26,6CM",SIMONAGGIO,Em linha,R21-B04-A00-P01,1213,18,0,1195
28731,260.441.0400.300,ARUBA - COLHER ARROZ ACO INOX 32 CM,SIMONAGGIO,Em linha,R22-B07-A00-P03,2364,76,0,2288
28732,260.441.0408.300 ,ARUBA - GARFO TRINCHANTE ACO INOX 32 CM,SIMONAGGIO,Em linha,R22-B07-A00-P02,808,34,0,774
28734,260.441.0412.300 ,ARUBA -  ESCUMADEIRA ACO INOX 32 CM,SIMONAGGIO,Em linha,R22-B07-A00-P01,2096,25,0,2071
48456,403.103.9074.202 ,DISNEY CARTELA - CJ TALHER 3 PCS MINNIE,SIMONAGGIO,Em linha,R21-B08-A00-P04,926,3,0,923
48452,403.102.9073.202 ,DISNEY CARTELA - CJ TALHER 2 PCS MINNIE,SIMONAGGIO,Promocao,R21-B07-A00-P01,686,12,0,674
48459,403.103.9074.204,DISNEY CARTELA - CJ TALHER 3 PCS FROZEN,SIMONAGGIO,Em linha,R21-B08-A00-P01,831,0,0,831
48455,403.102.9073.204,DISNEY CARTELA - CJ TALHER 2 PCS FROZEN,SIMONAGGIO,Promocao,R21-B07-A00-P03,836,6,0,830
48457,403.103.9074.201,DISNEY CARTELA - CJ TALHER 3 PCS MICKEY,SIMONAGGIO,Em linha,R21-B08-A00-P02,515,0,0,515
48453,403.102.9073.201 ,DISNEY CARTELA - CJ TALHER 2 PCS MICKEY,SIMONAGGIO,Promocao,R21-B07-A00-P02,996,18,0,978
48458,422.103.9074.210,DISNEY CARTELA - CJ TALHER 3 PCS HOMEM ARANHA,SIMONAGGIO,Em linha,R21-B08-A00-P03,1074,3,0,1071
48454,422.102.9073.210 ,DISNEY CARTELA - CJ TALHER 2 PCS HOMEM ARANHA,SIMONAGGIO,Promocao,R21-B07-A00-P04,786,6,0,780
40451,040.175.9084.213 || IK900/5-UC,KIDS - CJ TALHER 5 PCS UNICORNIO,SIMONAGGIO,Em linha,R21-B10-A02-P04,201,3,0,198
1356,040.103.9074.018 ,"TREVISO - CJ TALHER INF""GARFO,COLHER,FACA""ROSA",SIMONAGGIO,Em linha,R22-B07-A02-P02,719,24,0,695
40450,040.175.9084.212 || IK900/5-CR,KIDS - CJ TALHER 5 PCS MENINO,SIMONAGGIO,Em linha,R21-B10-A02-P03,210,3,0,207
1355,040.103.9074.015,"TREVISO - CJ TALHER INF""GARFO,COLHER,FACA""AZUL",SIMONAGGIO,Em linha,R22-B07-A02-P01,810,18,0,792
22409,360.101.0319.401 ,"FACA CARBONO 5"" ENCARTELADA",SIMONAGGIO,Em linha,R21-B01-A00-P04,2915,30,0,2885
22410,360.101.0320.401 ,"FACA CARBONO 6"" ENCARTELADA",SIMONAGGIO,Promocao,R21-B01-A00-P03,3074,55,0,3019
22411,360.101.0321.401 ,"FACA CARBONO 7"" ENCARTELADA",SIMONAGGIO,Promocao,R21-B01-A00-P02,3068,62,0,3006
38137,LS 305/5A-S,"FACA PEIXEIRA 5""",SIMONAGGIO,Lancamento,R22-B01-A01-P03,6000,0,0,6000
22412,360.101.0322.401 ,"FACA CARBONO 8"" ENCARTELADA",SIMONAGGIO,Em linha,R21-B01-A00-P01,1931,23,0,1908
28740,350.101.0320.400 ,"FACA INOX PEIXEIRA 6"" ENCARTELADA",SIMONAGGIO,Em linha,R22-B09-A00-P03,1000,12,0,988
28741,350.101.0321.400 ,"FACA INOX PEIXEIRA 7"" ENCARTELADA",SIMONAGGIO,Em linha,R22-B09-A00-P02,1280,13,0,1267
28742,350.101.0322.400,"FACA INOX PEIXEIRA 8"" ENCARTELADA",SIMONAGGIO,Em linha,R22-B09-A00-P01,1014,18,0,996
3847,001.101.0427.001,CHAIRA 08 POLEGADAS,SIMONAGGIO,Em linha,R21-B10-A02-P01,635,8,0,627
4335,001.101.0322.001,FACA PEIXEIRA 08 POLEGADA CABO BRANCO,SIMONAGGIO,Promocao,R21-B10-A01-P04,1865,53,0,1812
4334,001.101.0324.001,FACA P/COZINHA 07 POLEGADA CB.BRANCO,SIMONAGGIO,Promocao,R21-B10-A01-P03,1974,50,0,1924
7428,001.101.0313.001,FACA DE PAO UNIVERSAL,SIMONAGGIO,Em linha,R21-B08-A02-P04,1996,18,0,1978
22406,001.101.0317.001 ,FACA DE PAO CABO BRANCO,SIMONAGGIO,Em linha,R21-B03-A02-P02,6002,57,0,5945
55021,002.101.0313.007,"COOK TOOLS - FACA MULTIUSO 7"" VERMELHO",SIMONAGGIO,Promocao,R21-B08-A02-P03,296,12,0,284
55024,002.101.0316.007,COOK TOOLS - FACA PARA LEGUMES VERMELHO,SIMONAGGIO,Em linha,R21-B07-A02-P04,721,20,0,701
55022,002.101.0319.007,"COOK TOOLS - FACA PEIXEIRA 5"" VERMELHO",SIMONAGGIO,Em linha,R21-B07-A02-P01,1084,0,0,1084
55019,002.101.0321.007,"COOK TOOLS - FACA PEIXEIRA 7"" VERMELHO",SIMONAGGIO,Em linha,R21-B07-A02-P02,625,15,0,610
55020,002.101.0309.007,"COOK TOOLS - FACA CHEF 7"" VERMELHO",SIMONAGGIO,Em linha,R21-B08-A02-P02,640,21,0,619
57083,002.174.9064.007,CJ FACAS  C/ 04 PEÇAS VERMELHO BLISTER,SIMONAGGIO,Lancamento,R21-B06-A00-P04,757,0,0,757
57091,1280,CJ FACAS  C/ 05 PEÇAS BLISTER,SIMONAGGIO,Lancamento,R21-B10-A00-P04,467,3,0,464
42250,000.101.0020.300 || 269    ,BOMBA PARA MATE ENCARTELADA 23 CM,SIMONAGGIO,Em linha,R22-B07-A01-P05,182,0,0,182
11619,353.000.0616.300,ESPETO INOX SIMPLES PLUS 80 CM,SIMONAGGIO,Promocao,R22-B10-A00-P01,315,16,0,299
11618,353.000.0615.300 ,ESPETO INOX SIMPLES PLUS 70 CM,SIMONAGGIO,Em linha,R22-B10-A00-P02,600,16,0,584
11617,353.000.0614.300 ,ESPETO INOX SIMPLES PLUS 60 CM,SIMONAGGIO,Em linha,R22-B10-A00-P03,476,10,0,466
5563,353.000.0628.300,ESPETO INOX 85CM.DUPLO,SIMONAGGIO,Em linha,R22-B10-A00-P06,338,3,0,335
4339,353.000.0627.300,ESPETO INOX 75CM.DUPLO,SIMONAGGIO,Em linha,R22-B10-A00-P05,492,3,0,489
7980,030.405.9090.016 || MK 307-CP,"MARMITAS TERMICAS C/ 5 PCS 1,8 L CADA",SIMONAGGIO,Em linha,R21-B05-A02-P01,94,3,0,91
7979,030.403.9090.016 || MK-305,"MARMITAS TERMICAS C/ 3 PCS 1,8 L CADA",SIMONAGGIO,Em linha,R21-B04-A02-P02,40,0,30,40
7978,030.402.9088.016 || MK 304-CP,"MARMITAS TERMICAS C/ 2 PCS 1,8 L CADA",SIMONAGGIO,Em linha,R21-B06-A02-P01,46,0,0,46
38144,031.401.0700.014 || GT 201-1,GARRAFAO TERMICO 5L ,SIMONAGGIO,Em linha,R21-B03-A02-P03,192,3,0,189
7977,030.401.0707.016 || MK 303-CP,"MARMITA TERMICA TRIPLA 1,8 L",SIMONAGGIO,Em linha,R21-B06-A02-P02,148,0,0,148
7976,030.401.0705.016 || MK 302-CP,"MARMITA TERMICA DUPLA 1,8 L",SIMONAGGIO,Em linha,R21-B05-A02-P03,200,0,0,200
7975,030.401.0703.016 || MK 301-C,"MARMITA TERMICA SIMPLES 1,8 L",SIMONAGGIO,Em linha,R21-B05-A02-P02,1105,0,0,1105
22402,031.401.0701.016 || MK 401-CP,"MARMITA TERMICA ROSCA SIMOTHERMO 1,6 L",SIMONAGGIO,Em linha,R20-B01-A02-P03,203,2,0,201
22394,020.401.0502.001 ,PRATIKLAR TÁBUA P/CORTE BRANCA GDE  40 X 26 CM,SIMONAGGIO,Em linha,R21-B08-A01-P02,1064,7,0,1057
4332,020.401.0501.001 ,"PRATIKLAR TÁBUA P/CORTE BRANCA MED 22,5 X 35 CM",SIMONAGGIO,Em linha,R21-B08-A01-P03,4247,90,0,4157
4333,020.401.0500.001 ,PRATIKLAR TÁBUA P/CORTE BRANCA PEQ 20 X 27 CM,SIMONAGGIO,Em linha,R21-B04-A00-P03,2066,30,0,2036
19320,020.403.9041.001 || 1275/3,"PRATIKLAR KIT P/COZINHA(TÁBUA+MART+FACA 7"") CB BCO",SIMONAGGIO,Em linha,R22-B10-A02-P03,227,0,0,227
2505,020.401.0426.001,PRATIKLAR MARTELO P/CARNE,SIMONAGGIO,Em linha,R21-B03-A00-P04,657,15,0,642
56278,020.401.0502.009,PRATIKLAR TÁBUA P/CORTE OLIVE GDE 40 X 26 CM,SIMONAGGIO,Em linha,R21-B08-A01-P04,431,3,0,428
56277,020.401.0501.009,"PRATIKLAR TÁBUA P/CORTE OLIVE MED 22,5 X 35 CM",SIMONAGGIO,Em linha,R21-B04-A00-P04,1792,36,0,1756
57084,020.401.0500.009,PRATIKLAR TÁBUA PEQUENA P/CORTE 20X27CM VERDE,SIMONAGGIO,Lancamento,R21-B09-A00-P04,1270,2,0,1268
5505,020.401.0511.001 ,PRATIKLAR SEPARADOR P/TALHER C/TAMPA,SIMONAGGIO,Em linha,R21-B04-A02-P01,980,19,0,961
57090,AB-S,PEGADOR UNIVERSAL 29 CM,SIMONAGGIO,Lancamento,R20-B01-A02-P02,812,12,0,800
56450,28018V/5,PANELA TEFLON 5 CAMADAS Nº 18 PRETO,MARTINAZZO,Em linha,R20-B05-A02-P02,28,0,0,28
56452,28020V/5,PANELA TEFLON 5 CAMADAS Nº 20 PRETO,MARTINAZZO,Em linha,R20-B05-A02-P01,22,0,0,22
56454,26012/5,CANECÃO TEFLON 5 CAMADAS 1 L PRETO,MARTINAZZO,Em linha,R20-B06-A02-P04,70,1,0,69
56455,26014/5,"CANECÃO TEFLON 5 CAMADAS 1,5 L PRETO",MARTINAZZO,Em linha,R20-B06-A00-P01,82,1,0,81
38033,24020/5,FRIGIDEIRA TEFLON 5 CAMADAS 20 CM PRETO,MARTINAZZO,Em linha,R20-B10-A01-P03,146,4,0,142
38035,24022/5,FRIGIDEIRA TEFLON 5 CAMADAS 22 CM PRETO,MARTINAZZO,Em linha,R20-B10-A01-P05,149,4,0,145
38037,24024/5,FRIGIDEIRA TEFLON 5 CAMADAS 24 CM PRETO,MARTINAZZO,Em linha,R20-B09-A00-P03,92,10,0,82
38043,25022/5,PANQUEQUEIRA TEFLON 5 CAMADAS PRETO 22CM,MARTINAZZO,Em linha,R20-B10-A02-P01,83,6,0,77
45313,60118/5,ÚTIL NYLON - ESPATULA PRETO - 27 CM,MARTINAZZO,Em linha,R20-B04-A00-P02,176,24,240,152
45307,60115/5,ÚTIL NYLON - CONCHA PRETO - 26 CM,MARTINAZZO,Em linha,R20-B10-A01-P02,214,15,0,199
45310,60116/5,ÚTIL NYLON - ESPUMADEIRA PRETO - 28 CM,MARTINAZZO,Em linha,R20-B10-A01-P03,189,12,0,177
45316,60126/5,ÚTIL NYLON - COLHER DE ARROZ PRETO - 28 CM,MARTINAZZO,Em linha,R20-B10-A01-P01,294,18,0,276
56451,28018V/8,PANELA TEFLON 5 CAMADAS Nº 18 VERMELHO,MARTINAZZO,Em linha,R20-B07-A01-P02,24,0,0,24
56453,28020V/8,PANELA TEFLON 5 CAMADAS Nº 20 VERMELHO,MARTINAZZO,Em linha,R20-B07-A02-P01,23,0,0,23
56449,27022V/8,CAÇAROLA TEFLON 5 CAMADAS Nº 22 VERMELHO,MARTINAZZO,Em linha,R20-B06-A02-P05,29,0,0,29
56457,26012/8,CANECÃO TEFLON 5 CAMADAS 1 L VERMELHO,MARTINAZZO,Em linha,R20-B06-A02-P03,42,1,0,41
56458,26014/8,"CANECÃO TEFLON 5 CAMADAS 1,5 L VERMELHO",MARTINAZZO,Em linha,R20-B06-A00-P02,66,4,0,62
56459,26016/8,CANECÃO TEFLON 5 CAMADAS 2 L VERMELHO,MARTINAZZO,Em linha,R20-B04-A02-P01,52,0,0,52
38034,24020/8,FRIGIDEIRA TEFLON 5 CAMADAS 20 CM VERMELHO,MARTINAZZO,Em linha,R19-B09-A01-P01,100,0,0,100
38036,24022/8,FRIGIDEIRA TEFLON 5 CAMADAS 22 CM VERMELHO,MARTINAZZO,Em linha,R20-B10-A02-P04,110,0,0,110
38038,24024/8,FRIGIDEIRA TEFLON 5 CAMADAS 24 CM VERMELHO,MARTINAZZO,Em linha,R20-B09-A02-P05,55,0,0,55
38044,25022/8,PANQUEQUEIRA TEFLON 5 CAMADAS VERMELHO 22CM,MARTINAZZO,Em linha,R20-B10-A02-P03,87,0,0,87
45328,24922/M,FRIGIDEIRAS 22 CM - CJ C/ 9 PÇS SORTIDOS,MARTINAZZO,Em linha,,64,2,0,62
38042,55120V/05,"LIXEIRA EM INOX 12,5 LT C/ PEDAL",MARTINAZZO,Em linha,R19-B10-A02-P01,75,8,35,67
25843,54300/05,"LIXEIRA EM INOX 3,2 LT C/ TAMPA",MARTINAZZO,Em linha,R19-B09-A02-P03,82,4,0,78
25844,54400/05,"LIXEIRA EM INOX 6,3 LT C/ TAMPA ",MARTINAZZO,Em linha,R20-B08-A02-P03,85,2,20,83
25845,54500/05,"LIXEIRA EM INOX 9,1 LT C/ TAMPA ",MARTINAZZO,Em linha,R20-B06-A02-P01,61,0,0,61
55960,54049/5,"SUPORTE DE CHÃO P/ PAPEL HIG PRETO C/ LIXEIRA 6,3L",MARTINAZZO,Em linha,R20-B06-A00-P03,95,0,40,95
25846,54200/63,"LIXEIRA EM INOX 6,3 LT C/ TAMPA BASCULANTE",MARTINAZZO,Em linha,R20-B08-A02-P02,128,5,0,123
25847,54200/91,"LIXEIRA EM INOX 9,1 LT C/ TAMPA BASCULANTE",MARTINAZZO,Em linha,R20-B07-A02-P02,33,4,20,29
40436,40302,QUEIJEIRA INOX,MARTINAZZO,Em linha,R20-B02-A00-P03,57,18,30,39
38029,40301,BOLEIRA INOX ,MARTINAZZO,Em linha,R19-B09-A02-P01,67,18,30,49
48331,43320L,ATUAL - COLHER MESA 03 PCS,MARTINAZZO,Em linha,R20-B09-A02-P03,126,4,40,122
48333,43310L,ATUAL - GARFO MESA 03 PCS,MARTINAZZO,Em linha,R20-B08-A00-P03,120,4,80,116
48332,43335L,ATUAL - FACA CHURRASCO 03 PCS,MARTINAZZO,Em linha,R20-B08-A00-P02,156,0,60,156
18753,50190,VERAO - ESCUMADEIRA,MARTINAZZO,Em linha,R20-B04-A00-P01,529,11,0,518
18752,50180,VERAO - CONCHA,MARTINAZZO,Em linha,R20-B09-A01-P03,415,17,0,398
10816,50070,VERAO - COLHER P/ ARROZ INOX - AVULSA,MARTINAZZO,Em linha,R20-B10-A00-P03,1158,107,900,1051
17311,51220,VERAO - COLHER MESA INOX,MARTINAZZO,Em linha,R20-B10-A00-P05,345,0,460,345
17313,51230,VERAO - COLHER SOBREMESA INOX,MARTINAZZO,Em linha,R20-B09-A00-P01,505,7,0,498
17310,51210,VERAO - GARFO MESA INOX,MARTINAZZO,Em linha,R20-B10-A00-P04,367,0,0,367
17314,51250,VERAO - GARFO SOBREMESA INOX,MARTINAZZO,Em linha,R20-B09-A00-P04,271,0,0,271
17308,51235,VERAO - FACA CHURRASCO INOX,MARTINAZZO,Em linha,R20-B09-A00-P05,265,0,0,265
17312,51233,VERAO - FACA SOBREMESA INOX,MARTINAZZO,Em linha,R20-B09-A00-P04,185,0,0,185
32146,60000M,PRIMAVERA - CJ ESPATULA COLOR C/ 10 PCS,MARTINAZZO,Em linha,R20-B09-A00-P02,402,18,0,384
17303,50310,VERAO - GARFO MESA 03 PCS INOX,MARTINAZZO,Em linha,R20-B09-A02-P01,191,3,0,188
17304,50320,VERAO - COLHER MESA 03 PCS INOX,MARTINAZZO,Em linha,R20-B09-A02-P01,405,3,0,402
17302,50335,VERAO - FACA CHURRASCO 03 PCS INOX,MARTINAZZO,Em linha,R20-B08-A00-P01,94,0,0,94
28766,50620,VERAO - COLHER MESA 06 PCS,MARTINAZZO,Em linha,R20-B10-A00-P01,177,0,120,177
28765,50610,VERAO - GARFO MESA 06 PCS,MARTINAZZO,Em linha,R20-B09-A01-P04,41,0,240,41
28764,50634,VERAO - FACA MESA 06 PCS,MARTINAZZO,Em linha,R20-B10-A00-P02,307,0,120,307
32142,50155M,VERAO - CJ 15 PCS (COLHERES-SOBREM/CHA/CAFE),MARTINAZZO,Em linha,R20-B03-A01-P04,86,0,120,86
8299,50224,VERAO - FAQUEIRO 24 PECAS EM ACO INOX,MARTINAZZO,Em linha,R20-B07-A00-P01,77,0,0,77
8073,50206,VERAO - CJ PARA SOBREMESA 12 PECAS,MARTINAZZO,Em linha,R20-B03-A02-P03,162,2,0,160
8300,50251,VERAO - FAQUEIRO 51 PECAS EM ACO INOX,MARTINAZZO,Em linha,R20-B08-A02-P01,41,0,0,41
18765,60524/5,PRIMAVERA - FAQUEIRO 24 PCS CB PRETO C/POTE,MARTINAZZO,Em linha,R19-B10-A02-P02,86,2,120,84
49884,61020/5,PRIMAVERA - COLHER MESA 10 PCS PRETO,MARTINAZZO,Em linha,R20-B03-A02-P01,157,10,60,147
49885,61010/5,PRIMAVERA - GARFO MESA 10 PCS PRETO,MARTINAZZO,Em linha,R19-B09-A01-P02,785,9,0,776
49886,61035/5,PRIMAVERA - FACA MESA 10 PCS PRETO,MARTINAZZO,Em linha,R19-B09-A01-P03,278,19,0,259
49887,60320/5,PRIMAVERA - COLHER MESA 03 PCS PRETO,MARTINAZZO,Em linha,R19-B09-A01-P04,742,54,200,688
49888,60310/5,PRIMAVERA - GARFO MESA 03 PCS PRETO,MARTINAZZO,Em linha,R19-B10-A01-P05,590,48,200,542
49889,60335/5,PRIMAVERA - FACA MESA 03 PCS PRETO,MARTINAZZO,Em linha,R19-B10-A01-P04,706,62,400,644
38039,60524/6,PRIMAVERA - FAQUEIRO 24 PCS CB BRANCO C/POTE,MARTINAZZO,Em linha,R20-B02-A00-P04,78,0,60,78
51057,61020/6,PRIMAVERA - COLHER MESA 10 PCS BRANCO,MARTINAZZO,Em linha,R20-B04-A00-P03,181,6,0,175
51054,61010/6,PRIMAVERA - GARFO MESA 10 PCS BRANCO,MARTINAZZO,Em linha,R19-B10-A01-P01,365,6,0,359
51060,61035/6,PRIMAVERA - FACA MESA 10 PCS BRANCO,MARTINAZZO,Em linha,R20-B04-A00-P04,339,6,0,333
51045,60320/6,PRIMAVERA - COLHER MESA 03 PCS BRANCO,MARTINAZZO,Em linha,R20-B08-A01-P05,52,12,300,40
51042,60310/6,PRIMAVERA - GARFO MESA 03 PCS BRANCO,MARTINAZZO,Em linha,R20-B08-A01-P04,121,0,260,121
51051,60335/6,PRIMAVERA - FACA MESA 03 PCS BRANCO,MARTINAZZO,Em linha,R20-B03-A00-P02,144,0,280,144
51048,60325/6,PRIMAVERA - CJ MISTO 03 PCS BRANCO,MARTINAZZO,Em linha,R20-B03-A00-P01,99,17,180,82
38041,60524/8,PRIMAVERA - FAQUEIRO 24 PCS CB VERMELHO C/POTE,MARTINAZZO,Em linha,R20-B09-A01-P01,38,0,120,38
51058,61020/8,PRIMAVERA - COLHER MESA 10 PCS VERMELHO,MARTINAZZO,Em linha,R20-B03-A00-P04,130,6,120,124
51055,61010/8,PRIMAVERA - GARFO MESA 10 PCS VERMELHO,MARTINAZZO,Em linha,R20-B04-A00-P05,553,6,0,547
51061,61035/8,PRIMAVERA - FACA MESA 10 PCS VERMELHO,MARTINAZZO,Em linha,R19-B10-A01-P02,800,10,0,790
51046,60320/8,PRIMAVERA - COLHER MESA 03 PCS VERMELHO,MARTINAZZO,Em linha,R20-B03-A00-P03,441,0,100,441
51043,60310/8,PRIMAVERA - GARFO MESA 03 PCS VERMELHO,MARTINAZZO,Em linha,R20-B02-A00-P02,226,0,140,226
51052,60335/8,PRIMAVERA - FACA MESA 03 PCS VERMELHO,MARTINAZZO,Em linha,R20-B02-A00-P01,260,0,240,260
51049,60325/8,PRIMAVERA - CJ MISTO 03 PCS VERMELHO,MARTINAZZO,Em linha,R20-B08-A01-P06,174,18,100,156
8080,60212MO,PRIMAVERA - FAQUEIRO 12 PECAS CABO CORES SORTIDAS,MARTINAZZO,Em linha,R20-B04-A02-P02,125,10,0,115
8081,60218MO,PRIMAVERA - FAQUEIRO 18 PECAS CABO CORES SORTIDAS,MARTINAZZO,Em linha,R20-B10-A02-P02,87,4,0,83
8082,60224MO,PRIMAVERA - FAQUEIRO 24 PECAS CABO CORES SORTIDAS,MARTINAZZO,Em linha,R20-B04-A02-P03,115,6,0,109
48362,23180/32D5,SENSE - CX COMBO 180 PCS BLOOMINGDAHLIA LOVE,MARTINAZZO,Em linha,R20-B08-A01-P02,29,0,0,29
48364,23524/32D5,SENSE - CJ DE TALHERES 24 PC BLOOM. LOVE C/ POTE,MARTINAZZO,Em linha,R20-B08-A01-P03,51,2,0,49
48390,84180/5D3,URBANO - CX COMBO 180 PCS PRETO INFINITY,MARTINAZZO,Em linha,R20-B08-A01-P05,34,0,0,34
33081,30185,"WORLD - FACA INOX 5"" CB MADEIRA ENCART",MARTINAZZO,Em linha,R20-B05-A01-P02,112,0,60,112
8312,30186,"WORLD - FACA INOX 6"" CB MADEIRA ENCART",MARTINAZZO,Em linha,R20-B05-A01-P04,173,14,60,159
8313,30187,"WORLD - FACA INOX 7"" CB MADEIRA ENCART",MARTINAZZO,Em linha,R20-B05-A01-P01,235,27,0,208
8314,30188,"WORLD - FACA INOX 8"" CB MADEIRA ENCART",MARTINAZZO,Em linha,R20-B05-A01-P03,203,41,40,162
11343,30195M,"WORLD - FACA CARBONO 5"" CB MADEIRA ENCART",MARTINAZZO,Em linha,R20-B03-A01-P03,507,0,0,507
8315,30196M,"WORLD - FACA CARBONO 6"" CB MADEIRA ENCART",MARTINAZZO,Em linha,R20-B04-A01-P01,478,0,0,478
8316,30197M,"WORLD - FACA CARBONO 7"" CB MADEIRA ENCART",MARTINAZZO,Em linha,R20-B03-A01-P02,627,18,0,609
8317,30198M,"WORLD - FACA CARBONO 8"" CB MADEIRA ENCART",MARTINAZZO,Em linha,R20-B04-A01-P02,386,12,0,374
17300,30320,UNIVERSAL - COLHER MESA 03 PCS  CB MADEIRA,MARTINAZZO,Em linha,R20-B06-A01-P01,315,12,100,303
17298,30335,UNIVERSAL - FACA CHURRASCO 03 PCS  CB MADEIRA,MARTINAZZO,Em linha,R20-B03-A01-P01,460,0,100,460
15362,30202,UNIVERSAL - CJ TRINCHANTE 02 PCS CABO MADEIRA,MARTINAZZO,Em linha,R19-B09-A02-P02,600,12,600,588
8063,10061/65,CAMPING - ESPETO DUPLO CROMADO 65 CM,MARTINAZZO,Em linha,R20-B06-A01-P03,315,0,360,315
8064,10061/75,CAMPING - ESPETO DUPLO CROMADO 75 CM,MARTINAZZO,Em linha,R20-B07-A00-P02,264,0,120,264
8067,10205,CAMPING - CJ PARA CHURRASCO CABO LONGO 5 PECAS,MARTINAZZO,Em linha,R20-B01-A00-P03,35,1,0,34
57117,06800.04.02,VIVENCE BRANCO - CX COMBO 175 PC,TAUMER,Lancamento,R17-B09-A00-P03,57,0,30,57
57120,06100.04.02,VIVENCE BRANCO - COLHER MESA C/04 PC,TAUMER,Lancamento,R17-B09-A01-P01,740,6,200,734
57119,06300.04.02,VIVENCE BRANCO - GARFO MESA C/04 PC  ,TAUMER,Lancamento,R17-B08-A01-P01,697,6,200,691
57118,06200.04.02,VIVENCE BRANCO - FACA CARNE C/04 PC,TAUMER,Lancamento,R17-B08-A01-P02,655,6,200,649
57121,06101.04.02,VIVENCE BRANCO - COLHER CHÁ C/04 PC,TAUMER,Lancamento,R17-B09-A00-P01,417,6,0,411
57112,06800.04.17,VIVENCE CORAL - CX COMBO 175 PC,TAUMER,Lancamento,R17-B05-A00-P02,65,1,30,64
57115,06100.04.17,VIVENCE CORAL - COLHER MESA C/04 PC,TAUMER,Lancamento,R17-B07-A01-P02,831,12,200,819
57114,06300.04.17,VIVENCE CORAL - GARFO MESA C/04 PC  ,TAUMER,Lancamento,R17-B07-A01-P03,857,18,200,839
57113,06200.04.17,VIVENCE CORAL - FACA CARNE C/04 PC,TAUMER,Lancamento,R17-B07-A01-P01,769,12,200,757
57116,06101.04.17,VIVENCE CORAL - COLHER CHÁ C/04 PC,TAUMER,Lancamento,R17-B08-A00-P02,455,22,0,433
57102,06800.04.01,VIVENCE PRETO - CX COMBO 175 PC,TAUMER,Lancamento,R17-B05-A00-P05,22,2,100,20
57105,06100.04.01,VIVENCE PRETO - COLHER MESA C/04 PC,TAUMER,Lancamento,R17-B09-A01-P02,549,21,800,528
57104,06300.04.01,VIVENCE PRETO - GARFO MESA C/04 PC  ,TAUMER,Lancamento,R17-B09-A01-P04,314,21,900,293
57103,06200.04.01,VIVENCE PRETO - FACA CARNE C/04 PC,TAUMER,Lancamento,R17-B09-A01-P03,499,21,900,478
57106,06101.04.01,VIVENCE PRETO - COLHER CHÁ C/04 PC,TAUMER,Lancamento,R17-B07-A00-P04,156,22,500,134
57107,06800.04.03,VIVENCE VERMELHO - CX COMBO 175 PC,TAUMER,Lancamento,R17-B05-A00-P01,45,0,50,45
57110,06100.04.03,VIVENCE VERMELHO - COLHER MESA C/04 PC,TAUMER,Lancamento,R17-B07-A01-P04,724,9,300,715
57109,06300.04.03,VIVENCE VERMELHO - GARFO MESA C/04 PC  ,TAUMER,Lancamento,R17-B08-A01-P03,468,3,300,465
57108,06200.04.03,VIVENCE VERMELHO - FACA CARNE C/04 PC,TAUMER,Lancamento,R17-B07-A01-P05,568,3,300,565
57111,06101.04.03,VIVENCE VERMELHO - COLHER CHÁ C/04 PC,TAUMER,Lancamento,R17-B06-A01-P01,369,6,0,363
57126,02800.04.99,VENUS COMBO 175 PEÇAS,TAUMER,Lancamento,R17-B05-A00-P04,73,1,20,72
57128,02200.03.99,VENUS FACA CHURRASCO C/03 PCS,TAUMER,Lancamento,R17-B07-A00-P01,442,18,0,424
57123,02100.03.99,VENUS COLHER MESA C/3 PCS.CART,TAUMER,Lancamento,R17-B07-A00-P03,641,12,0,629
57131,02300.03.99,VENUS GARFO MESA C/3 PCS.CART,TAUMER,Lancamento,R17-B07-A00-P03,707,12,0,695
57125,02102.06.99,VENUS COLHER SOBREMESA C/06 PCS ,TAUMER,Lancamento,R17-B10-A01-P04,601,6,0,595
57124,02101.06.99,VENUS COLHER P/ CAFE 06 PCS,TAUMER,Lancamento,R17-B10-A01-P01,667,6,0,661
57129,02500.24.99,VENUS FAQUEIRO 24PCS,TAUMER,Lancamento,R17-B10-A01-P02,104,3,90,101
57122,02100.12.99,VENUS COLHER MESA - DUZIA,TAUMER,Lancamento,R17-B08-A02-P05,187,0,0,187
57130,02300.12.99,VENUS GARFO MESA - DUZIA,TAUMER,Lancamento,R17-B06-A01-P02,156,0,0,156
57127,02200.12.99,VENUS FACA CHURRASCO - DUZIA,TAUMER,Lancamento,R17-B06-A01-P03,161,0,0,161
57148,235,BOMBA PARA MATE C/ PEDRA,TAUMER,Lancamento,R17-B07-A02-P03,600,10,150,590
57150,237,BOMBA PARA MATE LISA,TAUMER,Lancamento,R17-B07-A02-P01,202,4,650,198
57151,121,BOMBA PARA TERERE LISA,TAUMER,Lancamento,R17-B07-A02-P02,207,9,350,198
57149,110,BOMBA PARA TERERE C/ PEDRA,TAUMER,Lancamento,R17-B07-A02-P04,652,6,200,646
57152,20800.01.02,TÁBUA 30 X 21 XM -  BRANCA,TAUMER,Lancamento,R17-B08-A02-P03,408,56,1200,352
57133,19101.01.99,VERSATILE COLHER P/ARROZ ,TAUMER,Lancamento,R17-B06-A01-P04,1611,0,0,1611
57137,19151.01.99,VERSATILE GARFO P/ASSADOS,TAUMER,Lancamento,R17-B05-A01-P02,755,0,0,755
57135,19111.01.99,VERSATILE PA PARA BOLO,TAUMER,Lancamento,R17-B05-A01-P03,1038,12,0,1026
57132,19191.01.99,VERSATILE CONCHA,TAUMER,Lancamento,R17-B10-A01-P03,1258,0,0,1258
57136,19121.01.99,VERSATILE PEGADOR DE SALADA,TAUMER,Lancamento,R17-B08-A02-P02,758,12,0,746
57134,19141.01.99,VERSATILE PEGADOR DE MASSA,TAUMER,Lancamento,R17-B08-A02-P01,780,27,0,753
57138,19131.01.99,VERSATILE PEGADOR UNIVERSAL,TAUMER,Lancamento,R17-B08-A02-P04,920,12,0,908
57147,22100.01.97,GRELHA DUPLA RETA PEQUENA 61X21CM,TAUMER,Lancamento,R17-B05-A01-P01,37,7,0,30
57146,22101.01.97,GRELHA DUPLA RETA MEDIA  73 X 21 CM,TAUMER,Lancamento,R17-B10-A00-P01,93,8,240,85
57145,22111.01.97,GRELHA DUPLA ABAULADA MEDIA  78 X 21 CM,TAUMER,Lancamento,R17-B08-A00-P01,131,2,30,129
57144,22130.01.97,GRELHA COM CABO DE MADEIRA 84 X 35 CM SIMPLES,TAUMER,Lancamento,R17-B10-A00-P02,83,6,0,77
57143,22120.01.97,GRELHA COM CABO DE MADEIRA 84 X 35 CM DUPLA,TAUMER,Lancamento,R17-B09-A00-P02,111,2,0,109
57140,23162.01.99,ESPETO INOX SIMPLES PLUS 75 CM,TAUMER,Lancamento,R17-B06-A00-P02,391,0,0,391
57139,23163.01.99,ESPETO INOX SIMPLES PLUS 65 CM,TAUMER,Lancamento,R17-B06-A00-P04,338,0,0,338
57142,23142.01.97,ESPETO INOX 75CM.DUPLO,TAUMER,Lancamento,R17-B06-A00-P01,386,18,0,368
57141,23143.01.97,ESPETO INOX 65CM.DUPLO,TAUMER,Lancamento,R17-B06-A00-P03,325,18,0,307
29555,11.012-9,PANELA DE PRESSAO 10 LITROS POLIDA,ALUMINIO ARARA,Em linha,R23-B03-A02-P01,47,3,0,44
7071,11.005-8,PANELA DE PRESSAO 7 LITROS POLIDA,ALUMINIO ARARA,Em linha,R26-B14-A00-P01,106,8,70,98
3882,11.003-0,"PANELA DE PRESSAO 4.5LTS.""SEGURA""",ALUMINIO ARARA,Em linha,R26-B13-A00-P01,375,10,50,365
2569,11.009-4,"PANELA DE PRESSAO 03LTS.""SEGURA""",ALUMINIO ARARA,Em linha,R23-B03-A02-P02,150,6,50,144
7570,11.001-1,PANELA DE PRESSAO 4.5 LTS EM CAIXA PARA PRESENTE,ALUMINIO ARARA,Em linha,R23-B04-A02-P03,67,0,15,67
2570,11.011-0,"PANELA DE PRESSAO 03LTS C/ANTI ADERENTE "" SEGURA""",ALUMINIO ARARA,Em linha,R23-B04-A02-P02,115,1,0,114
2539,11.008-5,"PANELA DE PRESSAO ARAFLON 4,5 LTS - CX PRESENTE",ALUMINIO ARARA,Em linha,R23-B04-A02-P01,90,2,0,88
57092,49.005-5,"ARAFLON PANELA Nº 18 – 2,085L",ALUMINIO ARARA,Lancamento,R22-B04-A01-P01,40,1,120,39
57093,49.006-4,"ARAFLON PANELA Nº 20 – 2,735L",ALUMINIO ARARA,Lancamento,R22-B05-A01-P01,36,1,90,35
57094,49.007-3,"ARAFLON PANELA Nº 22 – 3,692L",ALUMINIO ARARA,Lancamento,R22-B05-A01-P02,44,1,70,43
2254,49.023-3,"ARAFLON FRITADEIRA P/OVOS  0,35 LTS",ALUMINIO ARARA,Em linha,R23-B08-A01-P03,220,4,56,216
31509,49.017-1,ARAFLON OMELETEIRA N.19,ALUMINIO ARARA,Em linha,R23-B03-A01-P01,84,3,115,81
46884,49.030-4,ARAFLON FRIGIDEIRA GOURMET N 20 - 1 L,ALUMINIO ARARA,Em linha,R23-B04-A01-P01,108,4,0,104
46885,49.031-3,"ARAFLON FRIGIDEIRA GOURMET N 22 - 1,3 L",ALUMINIO ARARA,Em linha,R23-B04-A01-P01,154,3,0,151
46886,49.047-6,"ARAFLON FRIGIDEIRA GOURMET N 24 - 1,7 L",ALUMINIO ARARA,Em linha,R23-B04-A01-P03,224,3,0,221
46888,49.049-4,"ARAFLON FRIGIDEIRA GOURMET N 28 - 2,6 L",ALUMINIO ARARA,Em linha,R22-B03-A00-P02,74,1,20,73
46891,49.070-7,ARAFLON FRIGIDEIRA WOK C/ TAMPA N 24 - 3 L,ALUMINIO ARARA,Em linha,R23-B03-A01-P02,30,0,90,30
46892,49.071-6,"ARAFLON FRIGIDEIRA WOK C/ TAMPA N 28 - 4,6 L",ALUMINIO ARARA,Em linha,R23-B10-A01-P03,56,2,40,54
35725,03.047-6,"HOTEL FRIGIDEIRA C/ TEFLON 4,434 LTS N.34",ALUMINIO ARARA,Em linha,R23-B04-A00-P02,62,0,0,62
56504,03.085-0,"HOTEL FRIGIDEIRA C/ TEFLON 3,391 LTS N.30",ALUMINIO ARARA,Em linha,R23-B04-A00-P01,55,0,0,55
52546,49.094-0,PREMIUM CAÇAROLA COBRE Nº18,ALUMINIO ARARA,Em linha,R22-B03-A00-P03,119,4,0,115
52547,49.095-9,PREMIUM CAÇAROLA COBRE Nº20,ALUMINIO ARARA,Em linha,R22-B04-A00-P02,75,3,0,72
52548,49.096-8,PREMIUM CAÇAROLA COBRE Nº22,ALUMINIO ARARA,Em linha,R22-B04-A00-P01,64,4,0,60
52543,49.083-2,PREMIUM FRIGIDEIRA GOURMET COBRE Nº20,ALUMINIO ARARA,Em linha,R23-B06-A01-P01,242,21,0,221
52544,49.084-1,PREMIUM FRIGIDEIRA GOURMET COBRE Nº22,ALUMINIO ARARA,Em linha,R23-B06-A01-P02,227,17,0,210
52545,49.085-0,PREMIUM FRIGIDEIRA GOURMET COBRE Nº24,ALUMINIO ARARA,Em linha,R23-B04-A00-P03,135,12,24,123
52540,49.075-2,PREMIUM CANECÃO COBRE Nº12,ALUMINIO ARARA,Em linha,R22-B01-A01-P01,357,29,0,328
52541,49.076-1,PREMIUM CANECÃO COBRE Nº14,ALUMINIO ARARA,Em linha,R22-B01-A01-P02,268,29,0,239
52542,49.077-0,PREMIUM CANECÃO COBRE Nº16,ALUMINIO ARARA,Em linha,R22-B01-A01-P03,335,6,0,329
17764,90.047-6,"PIPOQUEIRA N.22  5,2 LTS",ALUMINIO ARARA,Em linha,R23-B01-A02-P02,88,9,0,79
2104,50.006-2,"REFORCADA CJ ""03X01"" POLIDO  5,1 LTS",ALUMINIO ARARA,Em linha,R23-B08-A02-P02,89,0,0,89
9127,50.002-6,"REFORCADA FORMA PUDIM 2 PCS  3,2 LTS",ALUMINIO ARARA,Em linha,R23-B08-A02-P01,106,6,0,100
40581,03.060-9,HOTEL SUPORTE PARA COADOR DE CAFÉ N 2 - 45 CM,ALUMINIO ARARA,Em linha,R23-B10-A02-P03,90,0,0,90
32535,03.073-4,"HOTEL ESCORREDOR N.40  12,5 LTS",ALUMINIO ARARA,Em linha,R23-B06-A00-P04,28,2,6,26
17755,03.022-4,HOTEL PLUS CACAROLA N.34  15 LTS,ALUMINIO ARARA,Em linha,R23-B07-A01-P02,31,0,0,31
17758,03.025-1,"HOTEL PLUS CACAROLA N.40  27,2 LTS",ALUMINIO ARARA,Em linha,R23-B05-A00-P01,24,0,0,24
17759,03.026-0,"HOTEL PLUS CACAROLA N.45  33,7 LTS",ALUMINIO ARARA,Em linha,R23-B01-A02-P01,22,0,3,22
31504,03.051-0,"HOTEL PLUS CALDEIRAO N.30  16,5 LTS",ALUMINIO ARARA,Em linha,R22-B03-A02-P01,22,0,0,22
31505,03.052-9,"HOTEL PLUS CALDEIRAO N.32  21,4 LTS",ALUMINIO ARARA,Em linha,R23-B05-A02-P02,22,0,0,22
2207,06.003-6,"REBATIDA CACAROLA CB.MADEIRA N.18  2,0 LTS",ALUMINIO ARARA,Em linha,R23-B08-A00-P03,106,0,0,106
2208,06.004-5,"REBATIDA CACAROLA CB.MADEIRA N.20 2,6 LTS",ALUMINIO ARARA,Em linha,R23-B08-A00-P02,102,0,0,102
2209,06.005-4,"REBATIDA CACAROLA CB.MADEIRA N.22  3,15 LTS",ALUMINIO ARARA,Em linha,R23-B08-A00-P01,65,0,0,65
2043,06.010-7,"REBATIDA CACAROLA C/ALCA N.18  2,0 LTS",ALUMINIO ARARA,Em linha,R23-B10-A00-P03,134,1,30,133
2044,06.011-6,"REBATIDA CACAROLA C/ALCA N.20  2,6 LTS",ALUMINIO ARARA,Em linha,R23-B09-A00-P02,106,3,45,103
2045,06.012-5,"REBATIDA CACAROLA C/ALCA N.22  3,15 LTS",ALUMINIO ARARA,Em linha,R23-B09-A00-P02,100,3,45,97
2046,06.013-4,"REBATIDA CACAROLA C/ALCA N.24  4,25 LTS",ALUMINIO ARARA,Em linha,R23-B09-A00-P01,109,3,0,106
2047,06.014-3,"REBATIDA CACAROLA C/ALCA N.26  5,0 LTS",ALUMINIO ARARA,Em linha,R23-B10-A00-P03,88,3,0,85
2048,06.015-2,"REBATIDA CACAROLA C/ALCA N.28   5,5 LTS",ALUMINIO ARARA,Em linha,R23-B10-A00-P02,83,1,0,82
2049,06.016-1,"REBATIDA CACAROLA C/ALCA N.30   6,5 LTS",ALUMINIO ARARA,Em linha,R23-B10-A00-P01,56,0,0,56
2050,06.017-0,REBATIDA CACAROLA C/ALCA N.32   8 LTS,ALUMINIO ARARA,Em linha,R23-B10-A00-P01,27,0,17,27
56502,36.009-7,"FORMA BOLO 02 ANDARES Nº 24 - 3,64 L",ALUMINIO ARARA,Em linha,R22-B02-A01-P01,214,4,0,210
56503,36.010-3,"FORMA BOLO 03 ANDARES Nº 24 - 3,65 L",ALUMINIO ARARA,Em linha,R22-B02-A01-P02,249,4,0,245
2227,34.001-1,"REFORCADA FORMA RETANG.ALTA 3,4 L - 32X22X5 CM",ALUMINIO ARARA,Em linha,R23-B07-A02-P02,131,5,96,126
2228,34.002-0,"REFORCADA FORMA RETANG.ALTA 4,9 L - 36X25X5,5 CM",ALUMINIO ARARA,Em linha,R22-B01-A02-P01,112,9,108,103
2229,34.003-0,"REFORCADA FORMA RETANG.ALTA 6,7 L - 40X28X6 CM",ALUMINIO ARARA,Em linha,R22-B02-A02-P02,197,9,0,188
2230,34.004-9,"REFORCADA FORMA RETANG.ALTA 8,2 L - 44X31X6 CM",ALUMINIO ARARA,Em linha,R22-B02-A02-P01,73,3,66,70
2133,31.001-2,"REFORCADA FORMA RETANG.BAIXA 2,7 L - 32X22X4 CM",ALUMINIO ARARA,Em linha,R23-B07-A02-P01,130,15,108,115
2134,31.002-1,"REFORCADA FORMA RETANG.BAIXA 3,5 L - 36X25X4 CM",ALUMINIO ARARA,Em linha,R23-B01-A01-P01,176,15,100,161
2135,31.003-0,"REFORCADA FORMA RETANG.BAIXA 5 L - 40X28X4,5 CM",ALUMINIO ARARA,Em linha,R23-B02-A01-P02,164,15,0,149
2136,31.004-0,"REFORCADA FORMA RETANG.BAIXA 6,2 L - 44X31X4,5 CM",ALUMINIO ARARA,Em linha,R23-B02-A01-P01,101,12,0,89
2119,32.003-7,"REFORCADA FORMA PAO/GELO 11 X 28 X 6,5 CM  1,96L",ALUMINIO ARARA,Em linha,R22-B02-A00-P03,260,9,0,251
2124,35.002-7,REFORCADA FORMA EMPADAS N.06,ALUMINIO ARARA,Em linha,R23-B05-A01-P03,136,4,0,132
56086,36.007-9,REFORCADA FORMA BOLO POLIDA N.16  1.058 L,ALUMINIO ARARA,Em linha,R23-B06-A00-P02,206,8,0,198
56087,36.008-8,"REFORCADA FORMA BOLO POLIDA N.18  1,408 L",ALUMINIO ARARA,Em linha,R23-B06-A00-P03,242,0,0,242
32537,36.004-1,"REFORCADA FORMA BOLO POLIDA N.20  1,89 LTS",ALUMINIO ARARA,Em linha,R23-B04-A01-P02,220,0,0,220
2120,36.001-4,"REFORCADA FORMA BOLO POLIDA N.22  2,35 LTS",ALUMINIO ARARA,Em linha,R23-B05-A01-P02,208,8,0,200
2121,36.002-3,"REFORCADA FORMA BOLO POLIDA N.24   3,0 LTS",ALUMINIO ARARA,Em linha,R23-B05-A01-P03,255,6,0,249
2122,36.003-2,"REFORCADA FORMA BOLO POLIDA N.26   3,55 LTS",ALUMINIO ARARA,Em linha,R23-B05-A01-P01,134,6,0,128
2128,33.007-0,"REFORCADA FORMA PIZZA N.32   1,6 LTS",ALUMINIO ARARA,Em linha,R23-B06-A01-P03,109,3,0,106
2129,33.009-8,"REFORCADA FORMA PIZZA N.35   1,7 LTS",ALUMINIO ARARA,Em linha,R23-B07-A00-P02,192,6,0,186
32536,33.010-4,REFORCADA FORMA PIZZA N.40  02 LTS,ALUMINIO ARARA,Em linha,R23-B08-A01-P02,85,0,0,85
17765,33.008-9,REFORCADA FORMA PIZZA FUNDO FURADO N.35,ALUMINIO ARARA,Em linha,R23-B06-A01-P03,108,0,0,108
46893,30.008-0,REFORCADA FORMA DE BOLO ALTA RED 20 CM - 3 L,ALUMINIO ARARA,Em linha,R23-B10-A02-P01,375,3,0,372
46894,30.009-9,"REFORCADA FORMA DE BOLO ALTA RED 25 CM - 4,8 L",ALUMINIO ARARA,Em linha,R23-B09-A02-P01,241,0,0,241
2131,30.006-1,"REFORCADA FORMA REDONDA N.30  4,13 LTS",ALUMINIO ARARA,Em linha,R23-B09-A01-P02,71,0,24,71
2802,30.004-3,"REFORCADA FORMA RED.FUNDO REMOVIVEL N.25  1,6 LTS",ALUMINIO ARARA,Em linha,R22-B03-A00-P01,107,2,0,105
33151,30.003-4,"REFORCADA FORMA RED.FUNDO REMOVIVEL N.30   3,1 LTS",ALUMINIO ARARA,Em linha,R22-B02-A00-P01,75,0,0,75
2095,18.001-6,"REFORCADA CANECAO POL.C/BAQU.N.12  1,2 LTS",ALUMINIO ARARA,Em linha,R22-B03-A01-P03,150,18,0,132
2096,18.002-5,REFORCADA CANECAO POL.C/BAQU.N.14 1.8LTS,ALUMINIO ARARA,Em linha,R23-B10-A01-P01,225,18,0,207
2097,18.003-5,REFORCADA CANECAO POL.C/BAQU.N.16 2.6LTS,ALUMINIO ARARA,Em linha,R22-B04-A01-P02,180,0,0,180
2139,41.002-7,"REFORCADA MARMITA OPERARIA N.16   1,3 LTS",ALUMINIO ARARA,Em linha,R23-B09-A01-P01,106,8,50,98
2805,53.001-6,"REFORCADA CANECAO CB.MADEIRA N.12   1,2 LTS",ALUMINIO ARARA,Em linha,R22-B03-A01-P02,221,4,0,217
2806,53.002-5,REFORCADA CANECAO CB.MADEIRA N.14 1.8LTS,ALUMINIO ARARA,Em linha,R22-B03-A01-P01,209,8,0,201
2807,53.003-4,REFORCADA CANECAO CB.MADEIRA N.16 2.6LTS,ALUMINIO ARARA,Em linha,R23-B07-A01-P01,235,18,0,217
2100,21.002-6,"REFORCADA CHALEIRA POL.N.18   2,942 LTS",ALUMINIO ARARA,Em linha,R23-B06-A02-P02,29,0,24,29
2080,12.003-6,"REFORCADA BULE POLIDO N.13 1,75 LTS",ALUMINIO ARARA,Em linha,R23-B10-A02-P02,99,11,0,88
2082,14.002-0,"REFORCADA CAFETEIRA POLIDA C/ COADOR N 13 1,75 LT",ALUMINIO ARARA,Em linha,R22-B02-A00-P02,77,0,0,77
2214,57.001-1,"REFORCADA CUSCUZEIRA  3,1 LTS",ALUMINIO ARARA,Em linha,R23-B06-A02-P01,240,0,0,240
35727,57.002-0,"REFORCADA CUSCUZEIRO N.16 2,5 LTS",ALUMINIO ARARA,Em linha,R23-B09-A02-P02,355,27,90,328
2225,22.006-9,HOTEL CONCHA N.12,ALUMINIO ARARA,Em linha,R23-B06-A00-P01,122,2,0,120
2103,22.002-2,REFORCADA CONCHA N.02,ALUMINIO ARARA,Em linha,R23-B04-A01-P02,145,0,150,145
2213,22.004-0,REFORCADA CONCHA N.02.CB.BAQUELITE,ALUMINIO ARARA,Em linha,R22-B01-A00-P02,368,16,0,352
2226,28.006-7,HOTEL ESCUMADEIRA N.13,ALUMINIO ARARA,Em linha,R23-B06-A00-P01,130,0,0,130
2112,28.002-0,REFORCADA ESCUMADEIRA N.02,ALUMINIO ARARA,Em linha,R22-B01-A00-P03,342,0,0,342
2014,28.004-9,REFORCADA ESCUMADEIRA N.02 CB.BAQUELITE,ALUMINIO ARARA,Em linha,R22-B01-A00-P02,551,12,0,539
31557,03.072-5,BALDE P/ CERVEJA E VINHO 06 LTS,ALUMINIO ARARA,Em linha,R23-B07-A00-P01,164,0,360,164
2076,10.003-3,REFORCADA BALDE N.28 11.000LTS,ALUMINIO ARARA,Em linha,R23-B08-A01-P01,54,0,0,54
17766,11.006-7,"BORRACHA SILICONE P/ PANELA PRESSAO 3,0 E 4,5 LTS ",ALUMINIO ARARA,Em linha,R22-B01-A00-P01,250,20,400,230
17768,11.021-8,BORRACHA SILICONE P/ PANELA PRESSAO 7 LTS,ALUMINIO ARARA,Em linha,R22-B01-A00-P03,320,20,0,300
17767,11.004-5,VALVULA UNIVERSAL DE SILICONE,ALUMINIO ARARA,Em linha,R22-B01-A00-P01,104,0,200,104
52524,7898563382397,MARMITA TERMICA 16 DIJON COLOR,TERMITA,Em linha,R24-B08-A00-P02,119,6,0,113
30410,7898563382953,"MARMITA TERMICA Nº 18 (NAPA PRETA) 1,6 LTS",TERMITA,Em linha,R24-B03-A00-P01,210,9,0,201
26238,7898945155243 ,"MARMITA TERMICA Nº 16 (NAPA PRETA) 1,35 LTS",TERMITA,Em linha,R24-B06-A00-P01,753,56,0,697
26236,7898945155267 ,"MARMITA TERMICA Nº 14 (NAPA PRETA) 1,10 LTS ",TERMITA,Em linha,R24-B09-A00-P01,448,66,0,382
26243,4277,"MARMITA TERMICA C/ BOLSA Nº 16 (NAPA PRETA) 1,35 L",TERMITA,Em linha,R24-B07-A00-P01,199,4,0,195
30411,7898563382946,"MARMITA TERMICA Nº 18 (TNT) 1,6 LTS",TERMITA,Em linha,R24-B03-A00-P02,164,6,0,158
26239,7898945154321 ,"MARMITA TERMICA Nº 16 (TNT) 1,35 LTS",TERMITA,Em linha,R24-B05-A00-P01,1228,72,0,1156
26237,7898945154338,"MARMITA TERMICA Nº 14 (TNT) 1,10 LTS",TERMITA,Em linha,R24-B10-A00-P02,1049,33,0,1016
26241,7898945155250 ,"MARMITA TERMICA RETANGULAR (NAPA PRETA ) 0,800 ML",TERMITA,Em linha,R24-B08-A00-P01,263,11,0,252
26240,7898945154314 ,"MARMITA TERMICA RETANGULAR ( TNT ) 0,800 ML",TERMITA,Em linha,R24-B04-A00-P01,373,12,0,361
57005,3301,"PORTA SABÃO COM TELA DEC - Ø13 X 4,5 CM",TERMITA,Lancamento,R25-B01-A00-P01,475,8,0,467
33108,7898563383295,LIXEIRA PIA C/ TAMPA,TERMITA,Em linha,R24-B10-A02-P01,731,4,0,727
30435,7898945154024,MARMITA OPERARIA Nº 16,TERMITA,Promocao,R24-B08-A02-P01,1119,4,0,1115
30434,7898945154017,MARMITA OPERARIA Nº 14,TERMITA,Promocao,R24-B08-A02-P03,712,0,0,712
57003,4345,MARMITA OPERARIA Nº 12 700 ML - Ø12 X 5 CM,TERMITA,Lancamento,R25-B02-A02-P02,989,6,0,983
30425,7898945155793,COQUETELEIRA 350 ML,TERMITA,Promocao,R23-B02-A00-P02,569,12,0,557
57008,119,BALDE P/ CERVEJA DEC 06 LTS - Ø23 X 20 CM,TERMITA,Lancamento,R25-B01-A02-P02,481,0,0,481
38145,3462,BALDE DE GELO CERVEJARIAS 2200 ML,TERMITA,Em linha,R24-B09-A02-P02,713,16,0,697
50000,7898945155359,PORTA LATA 355 ML,TERMITA,Em linha,R23-B01-A00-P02,425,0,0,425
35811,7898563383363,KIT C/ 02 COPOS CERVEJA 330 ML,TERMITA,Em linha,R24-B02-A00-P03,476,15,0,461
35808,7898563383349,CANECA CHOPP 600 ML,TERMITA,Em linha,R24-B01-A01-P01,327,12,0,315
56991,2724,CANECA JUICE 500ML SKOL E BRAHMA,TERMITA,Lancamento,R25-B01-A01-P02,766,21,0,745
56990,225,CANECA JUICE 500ML CARROS E MOTOS,TERMITA,Lancamento,R25-B02-A00-P01,418,6,0,412
56989,188,CANECA BALDINHO 600 ML,TERMITA,Lancamento,R25-B02-A01-P02,246,12,0,234
56992,3509,CANECA BOJUDA 550 ML,TERMITA,Lancamento,R24-B10-A01-P01,347,19,0,328
57002,126,CJ C/ 02 COPOS JUICE 350ML,TERMITA,Lancamento,R25-B02-A00-P03,458,0,0,458
57006,2762,CJ C/ 02 COPOS BELLA 350ML,TERMITA,Lancamento,R25-B02-A01-P01,580,11,0,569
33106,7898945155564 ,PAPEIRO BRILHO Nº 18,TERMITA,Em linha,R23-B01-A00-P01,1054,1,0,1053
57004,300,PAPEIRO LIXADO Nº 14 - 700ML - Ø14 X 7 CM,TERMITA,Lancamento,R25-B01-A01-P03,449,15,0,434
30418,7898563383035,CACAROLA C/ CABO Nº 16,TERMITA,Em linha,R24-B05-A02-P01,623,4,0,619
30417,7898563383028,CACAROLA C/ CABO Nº 14,TERMITA,Em linha,R24-B04-A02-P02,270,3,0,267
56471,1949,CAÇAROLA C/ CABO CÔNICA Nº 16 - 18 X 14 CM,TERMITA,Em linha,R24-B07-A01-P01,291,7,0,284
30431,7898563383073,FRIGIDEIRA FRANCESA Nº 18  ANTI ADERENTE,TERMITA,Em linha,R24-B01-A00-P02,580,22,0,558
52523,7898945155434,FRIGIDEIRA FRANCESA Nº 16 ANTI ADERENTE,TERMITA,Em linha,R24-B06-A01-P02,836,13,0,823
30432,7898563381116,FRITADEIRA DE OVO ANTI ADERENTE,TERMITA,Em linha,R24-B02-A00-P01,288,1,0,287
35810,7898563383356,PANQUEQUEIRA ANTI ADERENTE Nº 18,TERMITA,Em linha,R24-B02-A01-P02,596,6,0,590
35807,7898563383332,FRIGIDEIRA ANTI ADERENTE Nº 16,TERMITA,Em linha,R24-B04-A01-P02,577,2,0,575
30430,7898563383066,FRIGIDEIRA POLIDA Nº 18,TERMITA,Em linha,R24-B01-A01-P03,1423,0,0,1423
33101,7898945154529,FRIGIDEIRA BRILHO Nº 20,TERMITA,Em linha,R24-B01-A02-P01,759,1,0,758
56999,5205,"FRIGIDEIRA FRANCESA - Ø18 X 1,3 CM",TERMITA,Lancamento,R24-B10-A00-P01,855,31,0,824
57000,3097,FRIGIDEIRA LIXADA - Ø16 X 3 CM,TERMITA,Lancamento,R24-B06-A01-P03,826,30,0,796
57001,2755,"FRITADEIRA DE OVO LIXADO - Ø13 X 4,5 CM",TERMITA,Lancamento,R24-B02-A00-P02,961,3,0,958
56473,1963,FILTRO DE OLEO S/ TAMPA - 11 X 15 X 10 CM,TERMITA,Em linha,R24-B03-A01-P02,268,0,0,268
33099,3271,CANECAO Nº 10  C/ TAMPA 750 ML,TERMITA,Em linha,R24-B08-A01-P01,410,16,0,394
30424,3059,CANECAO Nº 14,TERMITA,Em linha,R24-B05-A02-P02,1267,60,0,1207
30423,7898563383042,CANECAO Nº 12,TERMITA,Em linha,R24-B02-A02-P02,300,22,0,278
52522,7898563381864,LEITEIRA ANTI ADERENTE PRETA 650 ML,TERMITA,Em linha,R23-B03-A00-P02,179,14,0,165
56470,2687,"LEITEIRA ALTA Nº 12 - 13 X 14 X 16 CM 1,4 LTS",TERMITA,Em linha,R24-B08-A02-P02,318,12,0,306
56994,2670,"CANECÃO Nº 12 1,1  L - Ø12 X 12 CM",TERMITA,Lancamento,R25-B01-A02-P01,1290,28,0,1262
56993,1826,"CANECÃO Nº 10 750 ML - Ø10 X 9,5 CM",TERMITA,Lancamento,R25-B02-A02-P01,810,36,0,774
56472,508,CUSCUZEIRO FOME ZERO - 12 X 23 X 17 CM 500 ML,TERMITA,Em linha,R24-B09-A02-P01,635,49,0,586
38153,7898563383820 ,CUSCUZEIRA 1100 ML,TERMITA,Em linha,R24-B06-A02-P02,418,0,0,418
51086,7898563384773,FORMA DE BOLO PISCINA 18 CM,TERMITA,Em linha,R24-B03-A02-P02,476,27,0,449
51087,4759,FORMA DE BOLO PISCINA 22 CM,TERMITA,Em linha,R24-B02-A02-P01,617,9,0,608
51088,7898563384780,FORMA DE BOLO PISCINA 26 CM,TERMITA,Promocao,R24-B06-A02-P01,524,2,0,522
57009,4697,FORMA CORAÇÃO Nº 02 PISCINA - 28X26X6 CM,TERMITA,Lancamento,R24-B10-A01-P02,473,18,0,455
57010,232,FORMA CORAÇÃO Nº 02 - 28 X 26 X 4 CM,TERMITA,Lancamento,R24-B04-A01-P01,402,12,0,390
56469,4643,"ASSADEIRA REDONDA ALTA Nº 18 - Ø18 X 7 CM 1,7 LTS.",TERMITA,Em linha,R24-B08-A01-P03,284,0,0,284
33096,7898563383004 ,ASSADEIRA REDONDA Nº 20,TERMITA,Em linha,R24-B08-A01-P02,301,2,0,299
33095,7898563382564 ,ASSADEIRA REDONDA Nº 22,TERMITA,Em linha,R24-B07-A02-P01,355,4,0,351
35809,7898563380799 ,ASSADEIRA RED ANTI ADERENTE Nº 18,TERMITA,Em linha,R24-B03-A01-P01,2882,5,0,2877
56985,1710,"ASSADEIRA REDONDA ALTA 1,1 L Ø16 X 7 CM ",TERMITA,Lancamento,R24-B09-A01-P03,519,3,0,516
56987,1703,ASSADEIRA REDONDA Ø20 X 5 CM,TERMITA,Lancamento,R24-B09-A01-P01,636,3,0,633
56986,1697,ASSADEIRA REDONDA Ø18 X 5 CM,TERMITA,Lancamento,R24-B09-A01-P02,788,3,0,785
56468,2991,ASSA FRANGO Nº 22 - Ø22 X 41 CM,TERMITA,Em linha,R23-B03-A00-P01,208,27,0,181
33097,7898563383264,ASSADEIRA REDONDA FUNDO REMOVIVEL Nº 20,TERMITA,Em linha,R24-B01-A02-P02,204,9,0,195
57007,3394,CJ C/ 02 FORMA EMPADÃO Nº 12,TERMITA,Lancamento,R25-B02-A01-P01,457,0,0,457
52521,7898563382403,FORMA BOLO E PUDIM PROFISSIONAL Nº 12 - PADARIA,TERMITA,Promocao,R24-B01-A00-P01,417,22,0,395
56995,966,"FORMA BOLO E PUDIM Nº 16 - Ø16,7 X 6,7 CM",TERMITA,Lancamento,R24-B06-A01-P01,661,6,0,655
56996,1857,"FORMA BOLO E PUDIM Nº 18 - Ø18,5 X 6,2 CM",TERMITA,Lancamento,R25-B02-A02-P03,794,12,0,782
30426,7898945154888,FORMA DE BOLO E PUDIM Nº 20,TERMITA,Em linha,R24-B05-A01-P02,449,27,0,422
30427,7898945154901,FORMA DE BOLO E PUDIM Nº 22,TERMITA,Promocao,R24-B05-A01-P01,1707,24,0,1683
35803,7898945154048,FORMA DE BOLO E PUDIM BX Nº 22,TERMITA,Em linha,R24-B01-A02-P03,276,6,0,270
30429,2984,FORMA P/ PIZZA 30 CM,TERMITA,Promocao,R24-B04-A02-P01,584,29,0,555
56998,1024,FORMA P/ PIZZA Nº 24 - Ø24 X 1 CM,TERMITA,Lancamento,R25-B01-A00-P02,663,6,0,657
30413,7898945154864,ASSADEIRA BAIXA Nº 1 - 19 X 28 X 3 CMS,TERMITA,Promocao,R24-B09-A02-P03,561,15,0,546
56997,5977,"FORMA DE PÃO Nº 01 - 22 X 4,5 CM",TERMITA,Lancamento,R24-B04-A01-P02,543,9,0,534
30428,7898945155984,FORMA DE PAO Nº 2,TERMITA,Em linha,R24-B10-A02-P02,494,9,0,485
33102,5519,JARRA BOJUDA BRILHO 1700 ML,TERMITA,Em linha,R24-B03-A02-P01,703,30,0,673
30433,7898945155625,LAVA ARROZ 25 CMS,TERMITA,Em linha,R24-B02-A01-P01,207,0,0,207
30415,7898563383011,BACIA Nº 30 ,TERMITA,Em linha,R24-B01-A01-P02,237,4,0,233
56988,65,BACIA Nº 20 - Ø20 X 5 CM,TERMITA,Lancamento,R25-B02-A00-P01,496,3,0,493
38150,7898563383813 ,COMEDOURO PARA CACHORRO 700 ML,TERMITA,Em linha,R23-B02-A00-P01,351,0,0,351
38151,7898563383806 ,COMEDOURO PARA GATO 300 ML,TERMITA,Em linha,R23-B01-A00-P03,184,0,0,184
53529,2748,MASCARA PROTECAO TNT (COLOR) EM TIRAS,TERMITA,Ponta de Estoque,,28300,24,0,28276
56489,3320,"FOSCO - ESCORREDOR FANTASTIK - 43 X 36 X 17,8 CM",ARTHI,Em linha,R26-B07-A02-P01,53,0,0,53
56490,3321,"FOSCO - ESCORREDOR MAX DUPLO - 39,7 X 25 X 26,2 CM",ARTHI,Em linha,R27-B06-A02-P02,34,0,0,34
56491,3322,FOSCO - ESCORREDOR FAN C/ PORTA COPOS - 31X34X19CM,ARTHI,Em linha,R27-B07-A02-P01,54,0,0,54
56494,3335,"FOSCO - PORTA TALHERES - 13 X 13 X 15,8 CM",ARTHI,Em linha,R26-B02-A01-P01,20,0,30,20
56495,3351,FOSCO - SUPORTE P/ PAPEL HIG. DUPLO CX ACOPLADA,ARTHI,Em linha,R26-B06-A01-P03,59,0,0,59
56496,3350,"FOSCO - PORTA TOALHAS DE LAVABO - 17,7 X 10,6 X 28 CM",ARTHI,Em linha,R26-B03-A01-P03,37,0,0,37
39206,2201,ROSE GOLD - ESCORREDOR MAX DUPLO - 40 X 27 X 27 CM,ARTHI,Em linha,R26-B09-A02-P02,69,3,0,66
39205,2200,ROSE GOLD - ESCORREDOR FANTASTIK - 43 X 36 X 18 CM,ARTHI,Em linha,R26-B10-A01-P01,94,2,0,92
46717,2205,ROSE GOLD - ESCORREDOR CAMA - 46 X 38 X 14 CM,ARTHI,Em linha,R26-B04-A02-P01,84,0,0,84
50043,2204,"ROSE GOLD - ESCORREDOR MAXXIMO - 54 X 38 X 10,5 CM",ARTHI,Em linha,R26-B05-A02-P01,35,0,0,35
39209,2228,"ROSE GOLD - PORTA GUARDANAPO - 14,5 X 5,5 X 10,2CM",ARTHI,Em linha,R26-B09-A01-P01,100,0,0,100
39211,2219,"ROSE GOLD - PORTA TALHERES - 13,5 X 14,5 X 9,7 CM",ARTHI,Em linha,R26-B09-A01-P03,56,0,24,56
39210,2221,"ROSE GOLD - PORTA ROLO DE PAPEL - 13,8X12,8X25,1CM",ARTHI,Em linha,R26-B07-A01-P03,54,2,60,52
46723,2235,ROSE GOLD - PORTA XÍCARA DE CAFÉ - 13 X 21 CM,ARTHI,Em linha,R26-B07-A01-P01,110,0,0,110
45388,2240,ROSE GOLD - PORTA PRATOS TRIPLO 29X23X40CM,ARTHI,Em linha,R27-B10-A02-P01,59,0,30,59
45383,2506,BLACK - ESCORREDOR MAX DUPLO - 40 X 27 CM,ARTHI,Em linha,R27-B08-A02-P01,44,0,0,44
45382,2505,BLACK - ESCORREDOR FANTASTIK - 43x36x18CM,ARTHI,Em linha,R26-B06-A02-P01,30,0,60,30
51095,2490,BLACK - ESCORREDOR FAN C/ PORTA COPOS - 39X20X26,ARTHI,Em linha,R27-B05-A02-P01,89,4,0,85
56474,2468,BLACK - PORTA TALHERES - 12 X 12 X 17 CM,ARTHI,Em linha,R27-B09-A00-P02,79,2,0,77
56477,2464,BLACK - SUPORTE PARA XÍCARA DE CHÁ - 18X17X26 CM,ARTHI,Em linha,R27-B05-A00-P03,151,0,0,151
56478,2463,BLACK - SUPORTE PARA XÍCARA DE CAFE - 16X13X21 CM,ARTHI,Em linha,R26-B05-A00-P03,131,0,0,131
52472,2486,BLACK - SUPORTE COMPLETO PARA COADOR DE CAFÉ,ARTHI,Em linha,R26-B04-A01-P01,62,8,0,54
56476,2467,BLACK - PORTA ROLO DE PAPEL TOALHA - 13X13X26 CM,ARTHI,Em linha,R27-B09-A01-P01,37,2,60,35
56969,2461,"BLACK - PORTA GUARDANAPO PEQ - 14,2 X 13 X 6 CM",ARTHI,Lancamento,R27-B05-A00-P02,43,2,30,41
56968,2462,"BLACK - PORTA GUARDANAPO GDE - 19,5 X 18 X 7 CM",ARTHI,Lancamento,R27-B04-A00-P02,31,2,30,29
56970,2459,BLACK - BANDEJA DE BANCADA - 37 X 18 X 9 CM,ARTHI,Lancamento,R27-B06-A01-P02,106,3,0,103
48710,2557,BLACK - SUPORTE MULTIUSO C/ RODIZIOS - 30 X 10 CM,ARTHI,Em linha,R27-B05-A00-P01,29,2,48,27
56483,2484,"BLACK - PORTA TOALHAS DE LAVABO - 20,5 X 10,7 X 31,6 CM",ARTHI,Em linha,R27-B09-A00-P01,70,0,20,70
52470,2478,"BLACK - PRATELEIRA HEXAGONAL - 37,5 X 16,5 X 37 CM",ARTHI,Em linha,R26-B03-A02-P01,29,0,0,29
56481,2566,BLACK - SUPORTE P/ PAPEL HIG. UNIT CX ACOPLADA,ARTHI,Em linha,R26-B09-A01-P03,68,0,60,68
56482,2563,"BLACK - SUPORTE DE CHÃO P/ PAPEL HIG - 13,2 X18,5 X49,5 CM",ARTHI,Em linha,R26-B05-A02-P02,43,5,30,38
46720,2512,BLACK - SUPORTE 4 ROLOS DE PAPEL - 17 X 15 X 47 CM,ARTHI,Em linha,R27-B08-A00-P02,39,0,0,39
36917,1051,ESCORREDOR MAX DUPLO 40X27X27 CM,ARTHI,Em linha,R26-B03-A02-P02,27,0,60,27
15081,1058,"ESCORREDOR MAXIMO C/ PORTA COPOS 54X38X10,5 CM",ARTHI,Em linha,R26-B10-A02-P01,60,0,30,60
7192,1072,ESCORREDOR CAMA TUBO CROMADO - 46X38X14 CM,ARTHI,Em linha,R26-B10-A00-P01,181,3,90,178
21599,1078,ESCORREDOR PRATIK - 16X34X43 CM,ARTHI,Em linha,R27-B06-A00-P01,95,9,120,86
4653,1067,ESCORREDOR FANTASTIC C/PORTA CP/TALHER 43X36X18 CM,ARTHI,Em linha,R26-B05-A00-P01,85,6,120,79
4652,1066,ESCORREDOR BERCO CROMADO C/PORTA CP 46X38X14 CM,ARTHI,Em linha,R26-B09-A00-P01,207,8,30,199
1714,1074,ESCORREDOR BERCO CROMADO 40X24X26 CM,ARTHI,Em linha,R26-B08-A02-P03,64,5,60,59
50044,1011,ESCORREDOR CROM FAN C/PORTA COPO 46X38X14 CM,ARTHI,Em linha,R26-B04-A02-P02,117,7,30,110
8118,1616,ART COOK - PORTA XICARAS PARA CAFE,ARTHI,Lancamento,R27-B06-A01-P01,125,11,100,114
8119,1617,ART COOK - PORTA XICARAS PARA CHA,ARTHI,Em linha,R26-B02-A01-P02,157,12,0,145
56972,1028,"PORTA GUARDANAPO PEQ - 14,2 X 13 X 6 CM",ARTHI,Lancamento,R27-B04-A00-P01,116,0,0,116
56971,1029,"PORTA GUARDANAPO GDE - 19,5 X 18 X 7 CM",ARTHI,Lancamento,R27-B06-A01-P04,79,0,0,79
1216,1120,SUPORTE PARA COADOR DE CAFE CROMADO,ARTHI,Em linha,R27-B07-A00-P01,486,24,0,462
52466,1637,PORTA ROLO DE PAPEL TOALHA NEW CROMADO,ARTHI,Em linha,R27-B08-A00-P04,122,0,0,122
7706,1612,ART COOK - PORTA ROLO PAPEL TOALHA,ARTHI,Em linha,R26-B07-A02-P02,71,0,0,71
22335,5108,"PORTA ROLO TRIPLO TRANSP - 31X37,5X2,8 CM",ARTHI,Em linha,R26-B07-A01-P02,106,4,0,102
35723,1646,QUERIDA - SUPORTE PAREDE  P/03 ROLOS PAPEL ,ARTHI,Em linha,R27-B09-A01-P03,67,0,36,67
8272,1150,ART COOK - SUPORTE PARA 3 ROLOS COM VENTOSA,ARTHI,Em linha,R26-B08-A02-P01,156,0,0,156
32465,5024,ORGANIZADOR DE GAVETAS C/ 05 PCS - 2 X 7 X 36 CMS,ARTHI,Em linha,R26-B10-A01-P03,65,9,60,56
33150,5826,CJ 06 CABIDES TINTUREIRO BRANCO,ARTHI,Em linha,R27-B08-A00-P01,178,0,0,178
4419,0060,CJ 02 CABIDES TRIPLO CALCA CROMADO,ARTHI,Em linha,R26-B04-A00-P01,109,0,180,109
16451,0041,CJ CABIDES TINTUREIRO  CROMADO - LV 6 PG 5,ARTHI,Em linha,R27-B09-A01-P02,74,6,60,68
4418,0050,CJ 03 CABIDES TINTUREIRO CROMADO,ARTHI,Em linha,R27-B09-A01-P01,277,8,0,269
4417,0030,CJ 02 CABIDES SAIA CROMADO,ARTHI,Em linha,R27-B08-A01-P02,128,12,120,116
4420,0070,CJ 02 SUPORTES TOALHA 04 GANCHOS CROMADO,ARTHI,Em linha,R27-B08-A01-P01,483,13,0,470
3933,2014,CABIDE P/PORTA,ARTHI,Em linha,R26-B03-A00-P02,522,67,0,455
11999,1020,CABIDE ECLIPSE PORTA,ARTHI,Em linha,R26-B06-A01-P02,109,5,0,104
11998,1015,CABIDE DE VASSOURAS,ARTHI,Em linha,R26-B03-A01-P02,161,0,60,161
22332,1022,CABIDE DE PORTA PARA VASSOURA E PA - 25X41X11 CM,ARTHI,Em linha,R26-B01-A01-P01,156,6,0,150
29362,1023,"SUPORTE ECLIPSE 7 GANCHOS -  32,5 X 9,5 X 32,5 CMS",ARTHI,Em linha,R27-B07-A01-P02,41,6,120,35
56487,5119,"POTE HERMÉTICO 1,7 L TPA TRANSP",ARTHI,Em linha,R26-B02-A01-P01,88,0,0,88
56486,5120,"POTE HERMÉTICO 2,3 L TPA TRANSP",ARTHI,Em linha,R26-B08-A02-P02,61,0,0,61
48544,1173,"DISPENSER DETERGENTE / BUCHA - 18 X 7,7 X 13 CM",ARTHI,Em linha,R26-B04-A01-P03,133,0,0,133
16450,1174,PORTA DETERGENTE E BUCHA,ARTHI,Em linha,R27-B07-A00-P02,75,0,0,75
51094,5054,DISPENSER DETERGENTE / BUCHA 550 ML BRANCO,ARTHI,Em linha,R27-B07-A00-P03,161,0,0,161
51093,5056,DISPENSER DETERGENTE / BUCHA /SABÃO 550 ML BRANCO,ARTHI,Em linha,R26-B01-A01-P02,40,0,10,40
45392,5079,LIXEIRA PRETA 5 LTS C/ TAMPA INOX - 19 X 30 CM,ARTHI,Em linha,R27-B08-A02-P02,75,0,0,75
52481,5314,ORGANIZ DE GAVETAS P/FACAS C/SEPARADOR MOVEL,ARTHI,Em linha,R27-B08-A01-P03,103,0,60,103
1214,1040,SUPORTE P/BUTIJAO CROMADO,ARTHI,Em linha,R28-B13-A00-P01,1140,79,240,1061
21600,1041,"SUPORTE P/BUTIJAO ESPECIAL - 24X9,5X30,5 CM",ARTHI,Em linha,R26-B07-A00-P01,230,22,0,208
32456,1112,SECADOR COPOS C/12 LUGARES CROMADO,ARTHI,Em linha,R26-B02-A02-P01,109,46,0,63
1730,1113,SECADOR DE COPOS C/20LUGARES CROMADO,ARTHI,Em linha,R26-B08-A01-P03,290,39,0,251
1623,1111,SECADOR DE COPOS C/06 LUGARES CROMADO,ARTHI,Em linha,R27-B10-A01-P02,194,13,0,181
38190,1336,CANTONEIRA COM VENTOSAS BRANCO,ARTHI,Em linha,R27-B10-A00-P02,96,4,0,92
38191,1337,SABONETEIRA COM VENTOSA BRANCO,ARTHI,Em linha,R27-B07-A01-P02,166,3,0,163
38183,1339,GANCHO COM VENTOSA BRANCO,ARTHI,Em linha,R26-B05-A01-P01,66,3,120,63
38186,1338,PORTA PAPEL HIGIENICO C/ VENTOSAS BRANCO,ARTHI,Em linha,R27-B09-A00-P02,73,3,120,70
1716,2133,PORTA SHAMPOO EPOXI DUPLO,ARTHI,Em linha,R26-B01-A00-P01,431,11,0,420
1731,2137,CANTONEIRA DUPLA EMBORRACHADA,ARTHI,Em linha,R26-B08-A00-P01,206,11,60,195
14203,1137,CANTONEIRA DUPLA CROMADA,ARTHI,Em linha,R26-B01-A00-P02,64,0,0,64
5021,1504,V. CANTO DUPLO BANCADA/PAREDE,ARTHI,Em linha,R26-B06-A02-P02,41,1,0,40
32461,1134,SUPORTE PAPEL HIGIENICO P/ 04 ROLOS CROMADO,ARTHI,Em linha,R27-B10-A00-P01,47,1,120,46
1732,2138,CANTONEIRA TRIPLA EMBORRACHADA,ARTHI,Em linha,R26-B06-A00-P01,132,8,0,124
16454,1138,CANTONEIRA TRIPLA CROMADA,ARTHI,Em linha,R27-B05-A02-P02,52,0,0,52
5019,1502,V. SUPORTE SHAMPOO/TOALHA BOX,ARTHI,Em linha,R27-B10-A02-P02,55,0,0,55
29364,1535,PORTA ESCOVAS E PASTA C/ TAMPA BRANCO,ARTHI,Em linha,R26-B03-A01-P02,99,0,30,99
17357,1914,PORTA ESCOVAS E PASTA C/ TAMPA BELLE PS CRISTAL,ARTHI,Em linha,R26-B05-A02-P03,110,0,0,110
48554,5068,ORGANIZADOR INCLINADO C/ DIV - 18 X 14 CM,ARTHI,Em linha,R26-B02-A01-P03,109,4,0,105
48545,1930,PORTA MAQUIAGEM P S CRISTAL - 17 X 11 X 19 CM,ARTHI,Em linha,R26-B03-A00-P03,57,0,20,57
36919,5903,CESTO DE ROUPAS QUADRADO 43 LTS - 39X26X59 CM,ARTHI,Em linha,R26-B10-A02-P02,66,3,0,63
12002,1546,CESTO DE ROUPAS FLEXIVEL 44 LTS,ARTHI,Em linha,R26-B02-A00-P02,85,0,0,85
30372,5004,CESTO DE ROUPA FLEXIVEL OVAL 32 LTS,ARTHI,Em linha,R27-B06-A02-P01,86,2,0,84
10425,1500,TAPETE P/ BOX C/ VENTOSAS  32 X 46 CM,ARTHI,Em linha,R26-B05-A01-P02,67,0,30,67
11651,1529,TAPETE MOSAICO  32 X 51 CM,ARTHI,Em linha,R26-B03-A00-P01,38,0,0,38
29363,1499,TAPETE P/ BOX NEW ANTIDERRAPANTE -30 X 36 X 66 CMS,ARTHI,Em linha,R26-B06-A01-P01,127,0,0,127
52479,5049,CAIXA ORGAN QUADRICULADA 22L BRANCA,ARTHI,Em linha,R26-B04-A01-P02,47,0,0,47
56967,1864,SAPATEIRA 08 PARES ENCARTELADO,ARTHI,Lancamento,R27-B06-A01-P03,85,0,0,85
45393,1860,SAPATEIRA 21 PARES PLASTICO - 55 X 25 X 95 CM,ARTHI,Em linha,R26-B04-A00-P03,163,0,0,163
30374,1840,"PRATELEIRA MULTIUSO C/ROD BCA - 54,5X12,5X77,5 CM",ARTHI,Em linha,R27-B09-A02-P02,51,4,0,47
28619,1833,ARARA STANDARD - 76X45X165 CM,ARTHI,Em linha,R27-B08-A00-P03,50,1,0,49
42429,322-4,SECADOR MIMO DUPLO C/ PORTA TALHER - 46X33X25 CM,NIQUELART,Em linha,R27-B02-A02-P01,23,0,20,23
45303,395-4,SECADOR POP C/PORTA TALHER BRANCO 33X19X23 CM,NIQUELART,Em linha,R28-B01-A01-P01,74,2,30,72
8363,100,"SECADOR PRINCESA CROMADO - 48X38X14,5 CM",NIQUELART,Em linha,R28-B02-A02-P01,141,4,80,137
22329,099,SECADOR RAINHA C/ PORTA COPOS - 51X15X38 CM,NIQUELART,Em linha,R27-B01-A02-P01,55,2,40,53
28674,106A,"SECADOR REI C/PORTA COPOS CROM - 39,5X26X25 CMS",NIQUELART,Em linha,R28-B04-A00-P03,173,0,390,173
10969,105,SECADOR BARONESA C/ PORTA COPOS - 41X37X18 CM,NIQUELART,Em linha,R28-B04-A02-P02,31,2,210,29
21621,110,"SECADOR BARONESA DE ARCO - 39,5X26X25 CM",NIQUELART,Em linha,R28-B05-A02-P02,286,19,40,267
12877,103,SECADOR VOVO - 51X39X14 CM,NIQUELART,Em linha,R27-B03-A02-P01,146,10,120,136
42430,346-4,SECADOR PRIME DUPLO C/ PORTA COPOS - 40X32X27 CM,NIQUELART,Em linha,R27-B01-A00-P02,45,0,90,45
42431,379-4,SECADOR RAINHA C/ PORTA COPOS E TALHER MIMO,NIQUELART,Em linha,R28-B01-A02-P01,68,0,60,68
42432,378-4,SECADOR REI C/PORTA COPOS E P/TALHER MIMO,NIQUELART,Em linha,R28-B07-A02-P02,57,2,120,55
42424,301-4,KIT PIA CROMO COLORS - BRANCO,NIQUELART,Em linha,R27-B04-A00-P03,66,2,0,64
42425,311-4,LIXEIRA DE PIA CROMO BRANCA,NIQUELART,Em linha,R27-B03-A00-P03,145,0,30,145
49945,404-4,KIT LIMPEZA 3 PEÇAS BRANCO,NIQUELART,Em linha,R27-B04-A00-P02,592,0,600,592
49944,403-4,"LIXEIRA 2,8 L BRANCO",NIQUELART,Em linha,R28-B03-A01-P02,463,78,240,385
42426,336-4,PORTA DETERGENTE ONDA CROMO BRANCA,NIQUELART,Em linha,R28-B04-A00-P02,165,12,30,153
45304,051,"MINI COADOR DE MESA - 6,5 CM",NIQUELART,Em linha,R29-B19-A00-P01,1350,432,1800,918
45305,055,COADOR DA FAZENDA - 12 CM,NIQUELART,Em linha,R27-B04-A01-P03,613,12,120,601
15368,056,SUPORTE P/ COADOR C/ PANO CROMADO - 34X16X15 CM,NIQUELART,Em linha,R27-B03-A01-P01,175,31,60,144
42428,333-4,"PORTA TALHER MIMO DUPLO C/ ALCA - 42X19,5X14 CM",NIQUELART,Em linha,R28-B03-A00-P01,76,6,0,70
8368,463,PORTA TALHER MESTRE CUCA CROMADO- 22X15X8 CM,NIQUELART,Em linha,R28-B04-A01-P02,150,0,120,150
15367,031,SUPORTE P/ PAPEL 02 ROLOS CROMADO - 34X24X16 CM,NIQUELART,Em linha,R28-B02-A01-P02,173,15,120,158
8361,087,"SUPORTE TRIPLO LUXO CROMADO - 38,5X34X13,5 CM",NIQUELART,Em linha,R27-B01-A01-P02,78,0,0,78
8362,088,PORTA PAPEL TOALHA LUXO CROMADO,NIQUELART,Em linha,R28-B01-A01-P03,206,10,240,196
22337,120,SECADOR COPOS PAREDE 20 LUGARES - 31X49X12 CM,NIQUELART,Em linha,R28-B02-A00-P03,47,0,0,47
22338,126,SECADOR COPOS PAREDE 12 LUGARES - 31X29X12 CM,NIQUELART,Em linha,R27-B01-A01-P03,25,0,200,25
36764,118,SECADOR COPOS 6 LUGARES CARROUSSEL CROMADO,NIQUELART,Em linha,R28-B03-A01-P01,138,11,0,127
33057,117,SECADOR COPOS 06 LUGARES,NIQUELART,Em linha,R27-B02-A01-P01,129,3,180,126
36765,119,SECADOR COPOS 8 LUGARES CROMADO,NIQUELART,Em linha,R28-B06-A02-P01,289,17,0,272
12783,550,FRITURAMA 22 CM,NIQUELART,Em linha,R27-B02-A01-P01,127,9,140,118
12782,053,SUPORTE BOTIJAO REFORCADO C/ RODIZIOS,NIQUELART,Em linha,R27-B02-A01-P03,139,2,210,137
42421,308-4,FRUTEIRA MESA CROMO BRANCA,NIQUELART,Em linha,R27-B01-A02-P02,61,1,40,60
8366,168,FRUTEIRA COPACABANA MESA CROMADA,NIQUELART,Em linha,R28-B07-A02-P01,164,23,250,141
8357,026,FRUTEIRA COPACABANA DUPLA CROMADA,NIQUELART,Em linha,R28-B04-A01-P01,331,6,0,325
8356,017,FRUTEIRA COPACABANA TRIPLA CROMADA,NIQUELART,Em linha,R27-B01-A00-P01,98,9,150,89
8407,018,FRUTEIRA RIO TRIPLA CROMADA,NIQUELART,Em linha,R27-B02-A00-P01,43,0,30,43
28667,600,DIAMANTE BOLEIRA C/ ALÇA 34X16 CM,NIQUELART,Em linha,R28-B07-A02-P02,88,0,0,88
28668,601,"DIAMANTE QUEIJEIRA C/ALÇA 22X13,5 CM",NIQUELART,Em linha,R28-B02-A01-P01,113,4,35,109
42418,437-10,DIAMANTE JARRA 3 LITROS,NIQUELART,Em linha,R28-B03-A02-P01,88,0,0,88
28655,439,JARRA MEDIDORA 600 ML,NIQUELART,Em linha,R27-B03-A01-P04,161,6,240,155
42419,436-10,CRYSTAL JARRA MEDIDORA TRANSP 600 ML,NIQUELART,Em linha,R27-B03-A01-P02,159,0,0,159
45299,337-10,"DIAMANTE - PORTA PAPEL TOALHA NATURAL - 16,5X29CM",NIQUELART,Em linha,R28-B06-A02-P02,129,52,60,77
45296,606-10,DIAMANTE - SALEIRO PAREDE / BANCADA - 17X9X11CM,NIQUELART,Em linha,R27-B04-A01-P02,120,24,120,96
45295,608,DIAMANTE - ACUCAREIRO/FARINHEIRA C/ COLHER 13X7CM,NIQUELART,Em linha,R28-B01-A01-P04,130,18,0,112
45291,603,DIAMANTE PORTA FRIOS C/ ALÇA 28X20X5 CM,NIQUELART,Em linha,R27-B02-A01-P02,55,18,0,37
45292,604-4,"DIAMANTE - PALITEIRO MESA BRANCO - 4,5 X 9 CM",NIQUELART,Em linha,R28-B02-A00-P02,471,0,0,471
45293,605-4,"DIAMANTE - SALEIRO MESA BRANCO - 4,5 X 9 CM",NIQUELART,Em linha,R28-B01-A01-P02,430,24,0,406
11616,347,PORTA VASSOURAS 9 GANCHOS COLORS,NIQUELART,Em linha,R27-B04-A01-P03,191,7,0,184
17246,067,CABIDE P/ TOALHA 04 LUGARES,NIQUELART,Em linha,R28-B02-A01-P04,191,8,240,183
33056,075,CABIDE P/ PORTA 08 GANCHOS,NIQUELART,Em linha,R27-B03-A01-P03,175,13,300,162
9649,540,GRELHA DUPLA RETA PEQUENA 61X20CM,NIQUELART,Em linha,R28-B04-A00-P05,117,4,0,113
9650,541,GRELHA DUPLA RETA MEDIA  69 X 25 CM,NIQUELART,Em linha,R28-B04-A00-P04,129,12,0,117
8030,508,GRELHA DUPLA ABAULADA PEQUENA  61 X 20 CM,NIQUELART,Em linha,R28-B04-A00-P01,99,9,156,90
8031,538,GRELHA DUPLA ABAULADA MEDIA  69 X 25 CM,NIQUELART,Em linha,R28-B03-A00-P02,149,4,60,145
8032,539,GRELHA DUPLA ABAULADA GRANDE  80 X 28 CM,NIQUELART,Em linha,R28-B03-A00-P04,91,0,0,91
8033,570,GRELHA COM CABO DE MADEIRA 82 X 36 CM,NIQUELART,Em linha,R28-B01-A00-P01,40,0,120,40
8034,571,GRELHA COM CABO DE MADEIRA 68 X 51 CM,NIQUELART,Em linha,R28-B01-A00-P02,64,3,90,61
42433,304-4,SUPORTE P/ PAPEL HIGIENICO C/ LIXEIRA,NIQUELART,Em linha,R28-B05-A02-P01,31,0,20,31
21623,1024,SUPORTE P/ PAPEL HIGIENICO 04 ROLOS - 38X12X22 CM,NIQUELART,Em linha,R28-B08-A02-P02,172,4,0,168
28653,077,PORTA SHAMPOO ACQUA,NIQUELART,Em linha,R27-B01-A01-P01,69,0,60,69
42416,307-4,CANTONEIRA TRIPLA CROMO BRANCA,NIQUELART,Em linha,R28-B03-A02-P02,45,3,0,42
42415,306-4,CANTONEIRA DUPLA CROMO - BRANCO,NIQUELART,Em linha,R27-B03-A02-P02,41,5,60,36
10356,264,CANTONEIRA SOL DUPLA CROMADA,NIQUELART,Em linha,R28-B02-A01-P03,96,3,20,93
42412,615-4,"GAVETEIRO 2G + 2P C/ ROD BCO - 41 X 76,5 X 42,5CM",NIQUELART,Em linha,R29-B19-A01-P01,26,0,30,26
28651,062-6,"CABIDE ADULTO C/CAVA - "" LEVE 6 PAGUE 5 """,NIQUELART,Em linha,R27-B04-A01-P01,131,6,0,125
10967,062-3,CABIDE ADULTO C/ 03 PCS,NIQUELART,Em linha,R27-B05-A01-P01,457,12,720,445
12770,326,CABIDE VIP ADULTO CRISTAL,NIQUELART,Em linha,R28-B04-A01-P02,370,12,160,358
42417,420-4,CESTO TELADO C/ TAMPA 32 LTS BRANCO,NIQUELART,Em linha,R27-B04-A02-P01,66,4,30,62
10968,073,CABIDE P/ PORTA 07 GANCHOS,NIQUELART,Em linha,R28-B02-A00-P01,339,18,120,321
45297,302-4,"CABIDEIRO MANCEBO BRANCO - 62,5 X 12",NIQUELART,Em linha,R28-B04-A00-P01,144,2,0,142
50103,3073,QUADRO DE METAL 30 X 40 CM - CERVEJA,NOVA ALIANCA,Promocao,R30-B33-A00-P01,796,45,270,751
50102,3059,QUADRO DE METAL 30 X 40 CM - CHURRASCO,NOVA ALIANCA,Promocao,R30-B32-A00-P01,135,60,1500,75
50104,3080,QUADRO DE METAL 30 X 40 CM - BEBIDA,NOVA ALIANCA,Promocao,R30-B36-A00-P01,915,45,0,870
50107,3066,QUADRO DE METAL 30 X 40 CM - VINTAGE,NOVA ALIANCA,Promocao,R30-B35-A00-P01,705,30,150,675
50108,3103,QUADRO DE METAL 30 X 40 CM - MOTOS,NOVA ALIANCA,Promocao,R30-B30-A00-P01,180,30,570,150
50106,3110,QUADRO DE METAL 30 X 40 CM - FRASES,NOVA ALIANCA,Promocao,R30-B34-A00-P01,540,75,600,465
50105,3035,QUADRO DE METAL 30 X 40 CM - BARBER SHOP,NOVA ALIANCA,Promocao,R30-B31-A00-P01,900,15,0,885
51209,2854,QUADRO DE METAL 20 X 30 - LINHA FRASES CERVEJA,NOVA ALIANCA,Promocao,R28-B09-A00-P03,270,0,300,270
51208,2045,QUADRO DE METAL 20 X 30 - LINHA VINTAGE,NOVA ALIANCA,Promocao,R28-B10-A01-P03,481,0,0,481
51204,1547,PLACA ,NOVA ALIANCA,Promocao,R28-B10-A02-P02,42,0,300,42
51207,3240,QUADRO DE METAL 20 X 20 - LINHA CERVEJA,NOVA ALIANCA,Promocao,R28-B09-A01-P02,570,0,0,570
51206,1062,QUADRO DE METAL 20 X 20 - LINHA GOURMET,NOVA ALIANCA,Promocao,R28-B10-A00-P03,315,15,0,300
51205,1086,QUADRO DE METAL 20 X 20 - LINHA INFANTIL,NOVA ALIANCA,Promocao,R28-B09-A00-P01,420,15,300,405
55995,1141,QUADRO DE METAL 10 X 15 CM - CHURRASCO / CERVEJA,NOVA ALIANCA,Em linha,R28-B07-A01-P04,1400,0,0,1400
56001,1257,QUADRO DE METAL 10 X 25 CM - CHURRASCO / CERVEJA,NOVA ALIANCA,Em linha,R28-B09-A02-P01,300,0,500,300
55998,1172,QUADRO DE METAL 15 X 15 CM - CHURRASCO / CERVEJA,NOVA ALIANCA,Em linha,R28-B07-A01-P03,1200,0,0,1200
55996,1158,QUADRO DE METAL 10 X 15 CM - GOUMET / CAFÉ,NOVA ALIANCA,Em linha,R28-B09-A01-P01,1299,0,0,1299
56002,1264,QUADRO DE METAL 10 X 25 CM - GOUMET / CAFÉ,NOVA ALIANCA,Em linha,R28-B10-A02-P03,1700,0,0,1700
55999,1189,QUADRO DE METAL 15 X 15 CM - GOUMET / CAFÉ,NOVA ALIANCA,Em linha,R28-B09-A02-P02,750,0,0,750
55997,1165,QUADRO DE METAL 10 X 15 CM - FRASES,NOVA ALIANCA,Em linha,R28-B10-A02-P04,700,0,0,700
56003,1271,QUADRO DE METAL 10 X 25 - FRASES,NOVA ALIANCA,Em linha,R28-B09-A02-P03,747,0,0,747
56000,1240,QUADRO DE METAL 15 X 15 CM - FRASES,NOVA ALIANCA,Em linha,R28-B08-A01-P03,635,0,300,635
51189,4517,BARRIL 27 CM BEBIDAS,NOVA ALIANCA,Promocao,R28-B10-A02-P01,643,15,0,628
51180,4210,TAMPA 27 CM CERVEJA,NOVA ALIANCA,Promocao,R28-B07-A01-P01,1035,0,480,1035
51182,4258,TAMPA 27 CM FRASES CERVEJA / CHURRASCO,NOVA ALIANCA,Promocao,R28-B08-A02-P01,1545,0,0,1545
51181,4241,TAMPA 27 CM REFRIGEIRANTE,NOVA ALIANCA,Promocao,R28-B10-A01-P01,1635,0,0,1635
51183,4623,RELOGIO TAMPA 27 CM CERVEJA,NOVA ALIANCA,Em linha,R30-B14-A00-P01,270,15,450,255
51185,4647,RELOGIO TAMPA 27 CM FRASES CERVEJA / CHURRASCO,NOVA ALIANCA,Em linha,R30-B18-A00-P01,578,240,240,338
51184,8706,RELOGIO TAMPA 27 CM REFRIGEIRANTE,NOVA ALIANCA,Em linha,R30-B15-A00-P01,371,0,0,371
54956,1448,PORTA CHAVE 14 X 21 CM,NOVA ALIANCA,Promocao,R28-B10-A00-P01,1233,6,0,1227
56721,754,ESTEIRA PARA BRAÇO DE POLTRONA,NOVA ALIANCA,Promocao,R30-B26-A00-P02,6177,1261,3870,4916
56714,5705,LIXEIRA DE METAL C/ PEDAL 12 L - PRETA,NOVA ALIANCA,Em linha,R30-B24-A00-P01,1842,30,0,1812
56713,5712,LIXEIRA DE METAL C/ PEDAL 12 L - BRANCA,NOVA ALIANCA,Em linha,R30-B19-A00-P01,972,6,600,966
56720,5100,LIXEIRA DE METAL TAMPA MOVEL 12 L - PRETA,NOVA ALIANCA,Em linha,R30-B22-A00-P02,409,0,120,409
56719,5094,LIXEIRA DE METAL TAMPA MOVEL 12 L - BRANCA,NOVA ALIANCA,Em linha,R30-B21-A00-P03,708,0,0,708
54953,5583,LIXEIRA DE METAL C/ PEDAL 12 L - COZINHA,NOVA ALIANCA,Em linha,R30-B28-A00-P01,1291,24,0,1267
56715,5032,LIXEIRA DE METAL TAMPA MOVEL 12 L - COZINHA,NOVA ALIANCA,Em linha,R30-B22-A00-P01,396,0,450,396
54954,5651,LIXEIRA DE METAL C/ PEDAL 12 L - GOURMET,NOVA ALIANCA,Em linha,R30-B29-A00-P01,1968,12,0,1956
56716,5087,LIXEIRA DE METAL TAMPA MOVEL 12 L - GOURMET,NOVA ALIANCA,Em linha,R30-B25-A00-P02,679,0,0,679
54955,5590,LIXEIRA DE METAL C/ PEDAL 12 L - BEBIDAS,NOVA ALIANCA,Em linha,R30-B27-A00-P01,1608,30,0,1578
56717,5049,LIXEIRA DE METAL TAMPA MOVEL 12 L - BEBIDAS,NOVA ALIANCA,Em linha,R30-B18-A00-P03,960,0,0,960
52636,5118,LIXEIRA DE METAL C/ PEDAL 18 L - COZINHA,NOVA ALIANCA,Em linha,R30-B25-A00-P01,44,0,0,44
51194,5064,LIXEIRA DE METAL C/ PEDAL 18 L - HEINEKEIN E BUD,NOVA ALIANCA,Em linha,R30-B17-A00-P02,208,0,0,208
51200,5323,PUFF DE METAL 40 CM - HEINEKEIN E BUD,NOVA ALIANCA,Em linha,R30-B16-A00-P01,38,0,0,38
52637,5316,CESTO 18 L COZINHA,NOVA ALIANCA,Ponta de Estoque,R30-B16-A00-P02,32,0,0,32
42195,9010,BALDE P/ DESTILADOS MASTER 10L,REDAR,Em linha,R25-B04-A02-P02,78,4,120,74
33281,BGM,BALDE P/ CERVEJA/VINHO MASTER 10 LTS,REDAR,Em linha,R25-B06-A01-P02,225,4,0,221
33280,BGC,BALDE P/ CERVEJA/VINHO 06 LTS,REDAR,Em linha,R25-B05-A00-P01,113,0,120,113
55922,453,"BALDE P/ GELO COLOR 4,7 LTS",REDAR,Em linha,R25-B04-A00-P01,310,4,96,306
42194,R 21,BALDE P/ LONG NECK MASTER 05L,REDAR,Em linha,R25-B04-A02-P01,79,3,180,76
33286,CC,COQUETELEIRA COLOR 550 ML,REDAR,Em linha,R25-B05-A00-P02,1349,464,900,885
45270,4019,CHOPEIRA ADESIVADA 3 L SORTIDA,REDAR,Em linha,R25-B06-A00-P02,96,2,0,94
33285,PGPC,PORTA GARRAFA C/ ADESIVO 300 ML,REDAR,Em linha,R25-B05-A01-P01,451,0,120,451
33284,PGC,PORTA GARRAFA C/ ADESIVO 600 ML,REDAR,Em linha,R25-B08-A02-P01,378,20,0,358
33283,ALA 02,CANECA CHOPP C/ ADESIVO 400 ML,REDAR,Em linha,R25-B04-A01-P02,716,17,180,699
55923,488,PORTA LATA COLOR,REDAR,Em linha,R25-B03-A00-P03,1422,461,1080,961
33268,JLPO,CJ LATA POA C/ 05 PCS,REDAR,Em linha,R25-B08-A00-P01,69,7,0,62
33276,JLP,CJ LATA PINTADO A MAO C/ 05 PCS,REDAR,Em linha,R25-B07-A00-P02,57,1,0,56
33273,JLD,CJ LATA DECOUPAGE C/ 05 PCS,REDAR,Em linha,R25-B06-A00-P01,43,0,0,43
35561,JLL,CJ LATA LIXADO C/ 05 PCS,REDAR,Em linha,R25-B07-A00-P01,67,2,0,65
35562,KPL,KIT PIA LIXADO,REDAR,Em linha,R25-B05-A02-P02,199,20,0,179
35563,JP,CJ DE PANELAS C/ 05 PCS COLOR,REDAR,Em linha,R25-B06-A02-P01,105,0,0,105
35564,JPC3P,CJ DE PANELAS C/ 03 PCS COLOR,REDAR,Em linha,R25-B05-A02-P03,39,0,110,39
54905,0869,MARMITA COLOR MINI - 6 X 10 CM,REDAR,Em linha,R25-B03-A01-P01,143,2,120,141
33266,KPPO,KIT PIA POA C/ 03 PCS,REDAR,Em linha,R25-B08-A02-P02,69,14,140,55
33274,KPP,KIT PIA PINTADO A MAO C/ 03 PCS,REDAR,Em linha,R25-B07-A02-P01,87,18,70,69
33271,KPD,KIT PIA DECOUPAGE C/ 03 PCS,REDAR,Em linha,R25-B07-A02-P02,144,12,70,132
33289,C 06,CACHEPO CRISANTEMO 12 X 16 CMS,REDAR,Em linha,R25-B03-A01-P02,332,40,120,292
33288,C 03,CACHEPO VIOLETA  08 X 11 CMS,REDAR,Em linha,R25-B04-A01-P01,314,48,480,266
56445,9589,CJ C/ 6 CANECAS COLORIDO 100ML,REDAR,Em linha,R25-B03-A02-P01,85,2,120,83
56444,9588,CANECA 350ML COLORIDO,REDAR,Em linha,R25-B03-A00-P01,323,0,0,323
56446,9590,CANECA 250ML COLORIDO,REDAR,Em linha,R25-B03-A02-P02,527,0,0,527
56447,9591,CANECA 100ML COLORIDO,REDAR,Em linha,R25-B03-A01-P03,360,0,320,360
49942,0914,CJ C/ 6 CANECAS COBRE 100ML,REDAR,Em linha,R25-B06-A01-P01,157,11,60,146
49941,0714,CANECA 350ML COBRE,REDAR,Em linha,R25-B05-A02-P01,1156,112,100,1044
49940,0713,CANECA 250ML COBRE,REDAR,Em linha,R25-B04-A01-P03,1064,105,0,959
49939,0917,CANECA 100ML COBRE,REDAR,Em linha,R25-B04-A00-P02,834,0,0,834
4311,3021,ESPREMEDOR DE ALHO BIG,BOA,Em linha,R28-B05-A00-P01,1303,74,120,1229
38273,3041    ,ESPREMEDOR DE ALHO REFORÇADO,BOA,Em linha,R28-B05-A00-P03,2071,75,180,1996
1103,3016,ESPREMEDOR DE ALHO 05 UTILIDADES,BOA,Em linha,R28-B05-A01-P02,1625,121,900,1504
1105,3019,ESPREMEDOR DE LEGUMES,BOA,Em linha,R28-B06-A00-P02,1028,83,1140,945
1104,3018,ESPREMEDOR DE LARANJA,BOA,Em linha,R28-B06-A00-P01,1951,141,60,1810
1106,3017,ESPREMEDOR DE LIMAO,BOA,Em linha,R28-B05-A01-P01,2385,273,2400,2112
38274,3042    ,COLHER DE SORVETE,BOA,Em linha,R28-B06-A01-P02,275,88,720,187
6042,3020,PILAO C/SOCADOR,BOA,Em linha,R28-B06-A01-P01,180,19,360,161
1060,3001,COLHER CABO MADEIRA,BOA,Em linha,R28-B06-A01-P03,589,48,720,541
1126,3002,GARFO CABO MADEIRA,BOA,Em linha,R28-B07-A00-P01,902,9,0,893
1100,3004,ESCUMADEIRA CABO MADEIRA,BOA,Em linha,R28-B07-A00-P03,512,56,720,456
1067,3003,CONCHA CABO MADEIRA,BOA,Em linha,R28-B05-A00-P02,503,53,720,450
1114,3012,FORMA BAURU,BOA,Em linha,R28-B08-A00-P01,1661,71,840,1590
4312,3024,MARTELO INTEIRICO,BOA,Em linha,R28-B08-A00-P02,870,19,0,851
6243,003106,CJ DE ABRIDORES/SACA-ROLHAS CART. C/03 PCS,VIEL,Em linha,R25-B10-A00-P01,562,0,0,562
6241,003115,ABRIDOR COMBINADO INT.INOX ENCARTELADO,VIEL,Em linha,R25-B10-A01-P05,698,72,120,626
1087,003305,FORMA EMPADA LISA ENCART 12 PECAS,VIEL,Em linha,R25-B10-A01-P01,48,0,0,48
1085,003101,ABRIDOR DE GARRAFA ENCART,VIEL,Em linha,R25-B09-A01-P02,570,0,0,570
6244,002116,COLHERES P/SUCO ACO INOX CART. C/03 PCS,VIEL,Em linha,R25-B09-A01-P02,171,0,0,171
1084,003103,ABRIDOR DE LATA E GARRAFA ENCART,VIEL,Em linha,R25-B10-A01-P02,694,51,240,643
1091,003803,RATOEIRA N.02 ENCART,VIEL,Em linha,R25-B09-A01-P04,323,0,0,323
1092,003109,SACA ROLHA ENCART,VIEL,Em linha,R25-B10-A01-P03,915,45,960,870
1090,003801,RATOEIRA N.01 ENCART,VIEL,Em linha,R25-B10-A00-P03,372,0,0,372
1198,003201,RALADOR 4 FACES,VIEL,Em linha,R29-B14-A00-P01,2856,552,1200,2304
9696,003210,RALADOR 4 UTILIDADES AÇO INOX ,VIEL,Em linha,R25-B10-A00-P02,138,3,0,135
1023,003007,BATEDOR ESPIRAL,VIEL,Em linha,R25-B10-A01-P04,92,7,0,85
4432,003600,PA DE LIXO METAL 19 X 19 CB.CURTO 20 CM,VIEL,Em linha,R25-B09-A00-P01,228,12,120,216
4433,003601,PA DE LIXO METAL 21X21 CB.LONGO 80CM,VIEL,Em linha,R25-B09-A00-P02,432,12,0,420
6245,003301,FORMA P/BOLO VERSATIL DIAM. 23CM,VIEL,Em linha,R25-B08-A01-P03,67,0,0,67
6247,003303,FORMA P/BOLO VERSATIL DIAM.27CM,VIEL,Em linha,R25-B09-A00-P03,34,0,0,34
9699,003561,"LIXEIRA FLANDRES C/PEDAL E CESTO 10,5 LTS BRANCA",VIEL,Em linha,R25-B08-A01-P01,22,0,0,22
5087,003565,"LIXEIRA ACO INOX C/PEDAL E CESTO 10,5 LTS",VIEL,Em linha,R25-B10-A02-P01,70,0,0,70
28626,003552,LIXEIRA PLASTICA C/PEDAL 05 LTS   BRANCA,VIEL,Em linha,R25-B08-A01-P02,78,0,0,78
28627,003582,LIXEIRA PLASTICA C/PEDAL 05 LTS   PRETA,VIEL,Em linha,R25-B09-A02-P03,81,0,0,81
26084,003541,LIXEIRA PLASTICA C/PEDAL 12 LTS   BRANCA,VIEL,Em linha,R25-B09-A02-P02,80,0,0,80
26085,003543,LIXEIRA PLASTICA C/PEDAL 12 LTS   PRETA,VIEL,Em linha,R25-B10-A02-P02,68,0,0,68
56043,13512,CANECA 360ML PRINCESAS C/ TAMPA COROA,PLASUTIL,Em linha,R32-B09-A01-P03,241,12,300,229
34652,008243,CANECA 360 ML PRINCESAS,PLASUTIL,Em linha,R32-B06-A01-P01,776,660,1792,116
48689,012760,SHAKEIRA 320 ML PRINCESAS,PLASUTIL,Em linha,R31-B04-A01-P02,1490,507,900,983
26931,006305,SHAKEIRA 580 ML PRINCESAS,PLASUTIL,Em linha,R30-B03-A02-P03,205,15,420,190
34654,008301,COPO SHAKE 500 ML PRINCESAS,PLASUTIL,Em linha,R29-B03-A01-P03,812,15,0,797
34602,008174,CANECA 360 ML FROZEN 2,PLASUTIL,Em linha,R32-B08-A01-P02,495,22,0,473
56041,13420,CANECA 360ML FROZEN C/ TAMPA COROA,PLASUTIL,Em linha,R32-B09-A01-P02,127,0,300,127
31499,006630,SHAKEIRA 320 ML FROZEN 2,PLASUTIL,Em linha,R31-B03-A01-P01,229,9,120,220
39493,008949,GARRAFA RETRÔ 500 ML FROZEN 2,PLASUTIL,Em linha,R33-B08-A01-P03,422,27,120,395
34604,008175,COPO 500 ML COROA FROZEN 2,PLASUTIL,Em linha,R29-B04-A01-P02,537,0,0,537
30359,006618,SHAKEIRA 580 ML FROZEN 2,PLASUTIL,Em linha,R30-B06-A02-P02,322,0,0,322
40497,001006    ,CANECA 360 ML UNICÓRNIO,PLASUTIL,Em linha,R32-B07-A01-P02,1565,639,1200,926
40521,001045    ,SHAKEIRA 320 ML UNICÓRNIO,PLASUTIL,Promocao,R31-B02-A01-P02,913,449,900,464
40513,001044    ,GARRAFA RETRÔ 500 ML UNICÓRNIO,PLASUTIL,Promocao,R33-B08-A00-P01,597,18,0,579
40506,001007    ,COPO SHAKE 500 ML UNICÓRNIO,PLASUTIL,Em linha,R29-B01-A01-P02,1465,585,900,880
40527,001008    ,SHAKEIRA 580 ML UNICÓRNIO,PLASUTIL,Em linha,R30-B06-A02-P03,435,19,0,416
26924,006314,POTE QUADRADO VALVULA MICKEY 170 ML,PLASUTIL,Em linha,R30-B03-A01-P03,423,48,260,375
46744,007742,CANECA 360 ML MINNIE BABY,PLASUTIL,Em linha,R32-B05-A01-P02,205,19,240,186
46749,007747,CANECA TRIO 330 ML MINNIE BABY,PLASUTIL,Em linha,R31-B09-A01-P03,1486,493,900,993
34632,008251,COPO 320 ML MINNIE ,PLASUTIL,Em linha,R33-B06-A00-P01,959,6,0,953
34631,008253,CANECA 360 ML MINNIE,PLASUTIL,Em linha,R32-B07-A01-P01,1531,640,1200,891
31501,006522,SHAKEIRA 320 ML MINNIE ,PLASUTIL,Em linha,R31-B02-A01-P01,1209,452,900,757
56931,13362,GARRAFA COMPARTIMENTO 360 ML MINNIE,PLASUTIL,Lancamento,R30-B01-A01-P02,330,15,0,315
39496,009081,GARRAFA RETRÔ 500 ML MINNIE VERMELHA,PLASUTIL,Em linha,R33-B07-A01-P03,1365,477,900,888
34633,008252,COPO SHAKE 500 ML MINNIE C/ CANUDO,PLASUTIL,Em linha,R29-B03-A01-P04,1775,600,900,1175
50077,012974,COPO 500 ML COM ORELHA MINNIE,PLASUTIL,Em linha,R29-B08-A00-P01,2802,704,880,2098
26930,006901,SHAKEIRA 580 ML MINNIE ,PLASUTIL,Em linha,R30-B05-A02-P02,578,35,210,543
46743,006317,CANECA 360 ML MICKEY BABY,PLASUTIL,Em linha,R32-B06-A01-P03,138,13,320,125
46748,007108,CANECA TRIO 330 ML MICKEY BABY,PLASUTIL,Em linha,R32-B09-A02-P01,1494,496,900,998
56930,9236,GARRAFA COMPARTIMENTO 360 ML MICKEY,PLASUTIL,Lancamento,R30-B01-A01-P01,385,15,0,370
34627,008273,CANECA 360 ML MICKEY CLUB HOUSE,PLASUTIL,Em linha,R32-B08-A01-P03,738,25,0,713
34629,006823,COPO 500 ML DEC MICKEY,PLASUTIL,Em linha,R29-B07-A00-P01,2352,640,880,1712
50078,012918,GARRAFA RETRO 500 ML MICKEY,PLASUTIL,Em linha,R33-B08-A01-P04,745,22,0,723
31502,006578,SHAKEIRA 320 ML MICKEY CLUB HOUSE ,PLASUTIL,Em linha,R31-B01-A01-P02,1003,449,900,554
26929,006902,SHAKEIRA 580 ML MICKEY ,PLASUTIL,Em linha,R30-B06-A02-P01,391,40,0,351
48657,012766,COPO 320 ML MÔNICA ,PLASUTIL,Em linha,R33-B05-A00-P03,190,6,552,184
48667,012765,GARRAFA RETRÔ 500 ML MÔNICA ,PLASUTIL,Em linha,R33-B08-A01-P03,317,21,240,296
48691,012764,SHAKEIRA 580 ML MÔNICA ,PLASUTIL,Em linha,R30-B04-A02-P02,207,12,0,195
48662,012763,COPO SHAKE 500 ML MÔNICA ,PLASUTIL,Em linha,R29-B02-A01-P02,87,45,720,42
34213,003227,CANECA 500 ML BATMAN ,PLASUTIL,Promocao,R32-B09-A01-P01,456,13,0,443
46792,001076,SHAKEIRA 320 ML BATMAN,PLASUTIL,Em linha,R31-B03-A01-P04,1195,453,900,742
39489,008975,GARRAFA RETRÔ 500 ML BATMAN,PLASUTIL,Em linha,R33-B07-A01-P02,1073,467,900,606
34212,008248,COPO SHAKE 500 ML BATMAN,PLASUTIL,Em linha,R29-B03-A01-P02,313,15,240,298
24388,005424,COPO 320 ML HOMEM ARANHA,PLASUTIL,Em linha,R33-B05-A00-P01,845,36,360,809
34613,008318,CANECA 360 ML HOMEM-ARANHA ,PLASUTIL,Em linha,R32-B07-A01-P03,1701,645,1200,1056
46794,001077,SHAKEIRA 320 ML HOMEM-ARANHA,PLASUTIL,Em linha,R31-B03-A01-P02,1642,475,900,1167
39495,008953,GARRAFA RETRÔ 500 ML HOMEM ARANHA,PLASUTIL,Em linha,R33-B07-A01-P04,821,47,300,774
34614,008316,COPO SHAKE 500 ML HOMEM-ARANHA,PLASUTIL,Em linha,R29-B04-A01-P03,1421,540,900,881
21516,006531,COPO 320 ML OS VINGADORES ,PLASUTIL,Em linha,R33-B05-A00-P02,214,31,720,183
34672,008326,CANECA 360 ML OS VINGADORES,PLASUTIL,Em linha,R32-B06-A01-P02,2032,663,1200,1369
34673,008281,COPO SHAKE 500 ML VINGADORES,PLASUTIL,Em linha,R29-B01-A01-P03,817,615,900,202
56933,6372,CANECA 360 ML MINIONS,PLASUTIL,Lancamento,R32-B10-A01-P04,498,28,0,470
56932,13920,CANECA 360 ML DIVERTIDA MINIONS,PLASUTIL,Lancamento,R32-B07-A01-P04,567,12,240,555
42308,001072,SHAKEIRA 320 ML MINIONS,PLASUTIL,Lancamento,R31-B03-A01-P03,593,442,900,151
56934,13919,COPO SHAKE 280 ML MINIONS,PLASUTIL,Lancamento,R31-B05-A01-P03,660,540,900,120
56935,13921,GARRAFA FOGUETE MINIONS 320 ML,PLASUTIL,Lancamento,R29-B02-A02-P01,1028,27,0,1001
9961,002615,COPO RETRATIL 330 ML,PLASUTIL,Em linha,R31-B10-A01-P01,527,6,0,521
54819,9763,CANECA TRIO 280 ML INFANTIL,PLASUTIL,Promocao,R30-B10-A01-P02,1048,40,0,1008
56402,013547,GARRAFA FOGUETE 320 ML,PLASUTIL,Promocao,R31-B10-A02-P03,2175,609,1200,1566
34668,008216,COPO TRIO 330 ML URSA,PLASUTIL,Em linha,R33-B10-A01-P03,500,6,0,494
34669,008217,CANECA TRIO 330 ML URSA,PLASUTIL,Em linha,R31-B09-A01-P02,1367,60,270,1307
39515,008201,SABONETEIRA URSA,PLASUTIL,Em linha,R33-B06-A01-P04,1138,82,360,1056
35557,008450,COPO TRIO 330 ML URSO,PLASUTIL,Em linha,R33-B10-A01-P04,399,10,0,389
35558,008451,CANECA TRIO 330 ML URSO,PLASUTIL,Em linha,R31-B10-A01-P03,1512,49,0,1463
39516,008430,SABONETEIRA URSO,PLASUTIL,Em linha,R33-B05-A01-P05,1328,81,0,1247
34667,008198,BANHEIRA 21 LTS URSA,PLASUTIL,Em linha,R29-B05-A00-P01,27,1,30,26
35554,008433,BANHEIRA 21 LTS URSO,PLASUTIL,Em linha,R29-B05-A00-P02,31,1,30,30
35555,008197,BANHEIRA 24 LTS ERGONOMICA URSA,PLASUTIL,Em linha,R29-B06-A00-P02,92,3,0,89
35556,008432,BANHEIRA 24 LTS ERGONOMICA URSO,PLASUTIL,Em linha,R29-B06-A00-P01,84,0,0,84
35545,008207,CESTO INFANTIL 38 LTS URSA,PLASUTIL,Em linha,R32-B06-A02-P01,86,2,0,84
35546,008437,CESTO INFANTIL 38 LTS URSO,PLASUTIL,Em linha,R32-B05-A02-P03,71,3,0,68
2354,003668,BANHEIRA 28 LTS ROSA,PLASUTIL,Em linha,R29-B02-A00-P01,52,0,0,52
2355,003662,BANHEIRA 28 LTS AZUL,PLASUTIL,Em linha,R29-B02-A00-P02,82,0,0,82
21527,007087,COPO TRIO 330 ML ARCO IRIS,PLASUTIL,Em linha,R33-B10-A01-P02,387,0,0,387
21529,007088,CANECA TRIO 330 ML ARCO IRIS,PLASUTIL,Em linha,R31-B10-A01-P02,1139,81,0,1058
21429,007121,CANECA 360 ML ARCO IRIS ,PLASUTIL,Em linha,R32-B08-A01-P01,214,48,400,166
39510,008291,SABONETEIRA ARCO IRIS,PLASUTIL,Em linha,R33-B06-A01-P03,783,39,360,744
15213,007092,BANHEIRA 21 LTS ARCO IRIS,PLASUTIL,Em linha,R29-B04-A00-P01,52,1,0,51
22316,007089,CESTO INFANTIL 38 LTS ARCO IRIS,PLASUTIL,Em linha,R32-B05-A02-P02,41,1,0,40
21526,007035,COPO TRIO 330 ML INFANTIL DINOSSAURO 330 ML,PLASUTIL,Em linha,R33-B10-A01-P01,575,0,0,575
21528,007036,CANECA TRIO 330 ML DINOSSAURO ,PLASUTIL,Em linha,R31-B09-A01-P01,1295,96,0,1199
21432,007059,CANECA 360 ML DINOSSAURO,PLASUTIL,Em linha,R32-B05-A01-P03,204,38,400,166
39514,008290,SABONETEIRA DINOSSAURO,PLASUTIL,Em linha,R33-B06-A01-P02,791,51,0,740
15212,007040,BANHEIRA 21 LTS DINOSSAURO,PLASUTIL,Em linha,R29-B04-A00-P02,58,2,0,56
22315,007037,CESTO INFANTIL 38 LTS DINOSSAURO,PLASUTIL,Em linha,R32-B05-A02-P01,45,1,0,44
53750,013162,"PORTA MASCARA DUPLO DEC - 8,5 X 12 X 4 CM",PLASUTIL,Promocao,R29-B10-A01-P02,834,6,0,828
11237,002847,PORTA COMPRIMIDOS REDONDO   77 X 19 MM,PLASUTIL,Em linha,R31-B06-A01-P03,413,0,120,413
56042,13450,"PORTA COMPRIMIDO FITNESS - 12 X 8 X 2,4 CM",PLASUTIL,Em linha,R31-B06-A01-P04,435,12,0,423
2358,000355,SABONETEIRA,PLASUTIL,Em linha,R30-B07-A01-P02,406,18,120,388
14181,002795,PORTA ESCOVA VIAGEM,PLASUTIL,Em linha,R30-B08-A01-P02,593,37,420,556
56401,005706,SHAKEIRA 580 ML FITNESS,PLASUTIL,Em linha,R30-B03-A02-P02,385,16,0,369
56397,013421,SHAKEIRA 600 ML FITNESS VIP,PLASUTIL,Em linha,R33-B10-A01-P05,194,1,0,193
56398,013448,GARRAFA 530 ML ABRE FACIL FITNESS,PLASUTIL,Em linha,R33-B09-A01-P05,513,39,360,474
56399,013449,GARRAFA 1 L ABRE FACIL FITNESS,PLASUTIL,Em linha,R30-B06-A00-P03,340,37,240,303
56400,013453,"SABONETEIRA FITNESS - 12 X 8,8 X 4,5 CM",PLASUTIL,Em linha,R33-B05-A01-P04,493,33,0,460
46797,007959,SHAKEIRA 580 ML TROPICAL,PLASUTIL,Em linha,R30-B04-A02-P03,331,0,0,331
26936,006396,SHAKEIRA 580 ML GEN ,PLASUTIL,Em linha,R30-B04-A02-P01,360,20,70,340
46796,007936,GARRAFA SHAKEIRA 580 ML FITNESS SORTIDA,PLASUTIL,Em linha,R30-B07-A02-P01,840,6,0,834
46769,001637,GARRAFA SHAKE 660 ML SORTIDA,PLASUTIL,Em linha,R31-B08-A01-P02,181,0,0,181
39471,000612,COPO C/ TAMPA FLIP 700ML,PLASUTIL,Em linha,R31-B05-A01-P04,189,10,120,179
39470,008989,COPO C/ TAMPA BICO 320ML,PLASUTIL,Em linha,R30-B03-A01-P01,754,6,0,748
34594,006820,COPO C/ TAMPA BICO 500ML,PLASUTIL,Promocao,R30-B09-A01-P03,451,0,0,451
39481,000607,COPO SHAKE 500 ML DEC. 02,PLASUTIL,Em linha,R29-B02-A01-P01,690,0,0,690
34595,006821,COPO SHAKE 500 ML DEC. 01,PLASUTIL,Em linha,R29-B03-A01-P01,524,0,0,524
34834,008039,GARRAFA RETRÔ 500 ML,PLASUTIL,Em linha,R33-B08-A00-P02,1261,38,900,1223
54827,665,COPO 320 ML COCA-COLA,PLASUTIL,Em linha,R33-B06-A00-P02,581,24,0,557
54828,013345,COPO 530 ML CRISTAL COCA-COLA,PLASUTIL,Em linha,R30-B09-A01-P04,348,0,0,348
54831,013056,COPO SHAKE 500 ML COCA-COLA,PLASUTIL,Em linha,R32-B10-A02-P03,774,15,0,759
54832,13053,GARRAFA RETRO 500 ML COCA-COLA,PLASUTIL,Em linha,R32-B09-A02-P03,526,3,0,523
54830,013055,COPO REFRI 700 ML COCA-COLA,PLASUTIL,Em linha,R32-B10-A02-P01,164,0,0,164
40528,008666    ,"SUQUEIRA RETRÔ 3,9 LTS",PLASUTIL,Em linha,R31-B09-A02-P01,46,0,0,46
35550,008038,"PET GARRAFA NEW YORK 1,8 LTS",PLASUTIL,Em linha,R31-B05-A02-P03,211,14,0,197
54816,3420,"BOLEIRA RED RETRÔ C/ ALCA E ROSCA - 28,5 X 12 CM",PLASUTIL,Em linha,R32-B10-A02-P02,197,6,0,191
56020,3424,"BOLEIRA RED CAFE DA MANHA FENDI 26 X 12,8 CM",PLASUTIL,Em linha,R29-B09-A02-P01,113,2,0,111
54850,3417,SERVE PAO RETRÔ,PLASUTIL,Em linha,R30-B07-A01-P03,200,13,0,187
54848,3394,QUEIJEIRA ROSCA CAFÉ DA MANHÃ FENDI - 20 X 9 CM,PLASUTIL,Em linha,R31-B01-A02-P01,473,22,0,451
54844,8696,POTE RETANGULAR 1L C/ 2 DIV CAFÉ DA MANHÃ FENDI,PLASUTIL,Em linha,R30-B06-A01-P03,796,33,0,763
39507,008341,POTE MORTADELA RETRO 750 ML,PLASUTIL,Em linha,R31-B06-A01-P02,282,39,490,243
56023,6142,PORTA CAFÉ E FILTRO DEC CAFÉ DA MANHA FENDI,PLASUTIL,Em linha,R30-B09-A02-P01,204,36,30,168
56024,6143,PORTA ACUCAR C/ COLHER CAFÉ DA MANHA FENDI,PLASUTIL,Em linha,R30-B09-A02-P02,157,6,0,151
54840,1727,PORTA FILTRO PARA CAFÉ RETRÔ,PLASUTIL,Em linha,R32-B07-A00-P01,652,43,480,609
56283,6144,PORTA FILTRO DE CAFE DEC FENDI,PLASUTIL,Em linha,R30-B03-A01-P02,377,0,0,377
54818,8687,CANECA 360 ML CAFÉ DA MANHÃ FENDI,PLASUTIL,Em linha,R32-B05-A01-P04,1154,24,0,1130
52458,009627,CANECA 360 ML DEC,PLASUTIL,Em linha,R32-B05-A01-P01,451,12,0,439
56396,013904,COPO SHAKE 280 ML COLORS,PLASUTIL,Em linha,R33-B07-A01-P01,300,0,0,300
56395,013905,COPO REFRI 270 ML COLORS,PLASUTIL,Em linha,R33-B06-A01-P01,390,0,0,390
56049,13646,"CRISTAL - PORTA MANT 1,24L QUAD TRAVA MAIS",PLASUTIL,Em linha,R29-B02-A02-P02,82,15,480,67
56048,13645,CRISTAL - PORTA MANT 830ML QUAD TRAVA MAIS,PLASUTIL,Em linha,R30-B02-A02-P04,154,18,450,136
56047,13644,CRISTAL - PORTA MANT 380ML QUAD TRAVA MAIS,PLASUTIL,Em linha,R30-B02-A02-P03,408,6,0,402
56022,5582,"CRISTAL - PETISQUEIRA C/ BANDEJA - 35 X 22 X 3,8CM",PLASUTIL,Em linha,R30-B05-A01-P01,88,0,0,88
56421,013653,CRISTAL - TAÇA GIN 500 ML,PLASUTIL,Em linha,R30-B05-A01-P04,229,0,120,229
56044,13519,"PORTA AZEITE FENDI - 7,6 X 18,6 CM",PLASUTIL,Em linha,R31-B04-A01-P01,97,1,0,96
56046,13524,PORTA QUEIJO RALADO C/ ALCA FENDI - 11 X 8 X 12 CM,PLASUTIL,Promocao,R30-B01-A01-P03,452,21,0,431
56045,13521,SALEIRO C/ ALCA FENDI - 11 X 8 X 12 CM,PLASUTIL,Promocao,R30-B05-A01-P03,490,31,0,459
51110,001723,PORTA CONDIMENTOS ROSCA 03 PCS,PLASUTIL,Promocao,R31-B01-A02-P02,1297,4,0,1293
56416,013549,"POTE FLIP 700ML - Ø12,3 X 9,5 CM",PLASUTIL,Em linha,R30-B02-A02-P01,145,0,0,145
56414,013554,"POTE FLIP 1,1L - Ø13,2 X 12,8 CM",PLASUTIL,Em linha,R30-B02-A00-P01,118,0,0,118
56415,013559,"POTE FLIP 1,9L - Ø14 X 18,2 CM",PLASUTIL,Em linha,R30-B02-A00-P02,86,2,60,84
54838,9564,KIT MEDIDOR 9 PÇS,PLASUTIL,Promocao,R31-B06-A01-P01,238,0,0,238
50068,007938,POTE RETANGULAR 1L C/ 3 DIV SORTIDA,PLASUTIL,Em linha,R30-B06-A01-P02,327,0,0,327
38081,008077,"MARMITA FIT 520 ML - 19,6X10,6X10,8 CM SORTIDA",PLASUTIL,Em linha,R29-B01-A02-P01,147,5,0,142
9341,002607,LAVA TUDO OVAL,PLASUTIL,Em linha,R30-B06-A00-P01,950,57,0,893
1919,000503,PEGADOR DE MACARRAO,PLASUTIL,Em linha,R31-B03-A00-P01,344,30,600,314
1921,000498,COLHER,PLASUTIL,Em linha,R31-B04-A00-P01,1129,65,900,1064
1915,000499,ESCUMADEIRA,PLASUTIL,Em linha,R31-B04-A00-P02,1036,55,480,981
1917,000501,CONCHA,PLASUTIL,Em linha,R31-B04-A00-P03,947,65,1200,882
1918,000502,ESPATULA,PLASUTIL,Em linha,R31-B03-A00-P02,2004,133,720,1871
46775,006323,PET KIT ORG GIRE TRAVE C/4 - 155ML,PLASUTIL,Em linha,R30-B02-A01-P02,215,15,0,200
46776,006350,PET KIT ORG GIRE TRAVE C/4 -220ML CAFÉ MANHA FENDI,PLASUTIL,Em linha,R30-B02-A01-P03,128,30,0,98
51106,012885,PET POTE PLUG QUADRADO 2 L,PLASUTIL,Promocao,R32-B09-A02-P04,379,3,0,376
51105,012884,"PET POTE PLUG QUADRADO 1,28 L",PLASUTIL,Promocao,R32-B09-A02-P02,392,3,0,389
51107,012883,PET POTE PLUG QUADRADO 510 ML,PLASUTIL,Promocao,R32-B10-A01-P02,358,9,0,349
25255,005993,POTE TRIO QUADRADO BAIXO 1000 ML,PLASUTIL,Em linha,R29-B06-A01-P01,693,18,0,675
25256,005994,POTE TRIO QUADRADO BAIXO 1800 ML,PLASUTIL,Em linha,R29-B06-A01-P02,255,18,0,237
25260,005998,POTE TRIO RETANG ALTO 1200 ML,PLASUTIL,Em linha,R29-B05-A01-P03,171,12,180,159
56941,12809,KIT PORTA DETERGENTE 600 ML C/ RODO - FENDI,PLASUTIL,Lancamento,R32-B14-A00-P03,727,16,0,711
48676,003427,PORTA ESCOVA 770ML TRAMA FENDI,PLASUTIL,Em linha,R33-B10-A00-P02,1102,34,0,1068
48677,003440,PORTA SAB. LIQUIDO 360ML TRAMA FENDI,PLASUTIL,Em linha,R33-B09-A00-P02,1135,12,0,1123
48686,007771,RODINHO DE PIA 13 CM FENDI,PLASUTIL,Em linha,R32-B01-A00-P01,3684,262,2100,3422
52457,007778,RODINHO DE PIA 16CM FENDI,PLASUTIL,Promocao,R31-B10-A00-P02,2258,225,1800,2033
48675,006977,PORTA DETERGENTE COMPLETO  600 ML,PLASUTIL,Em linha,R33-B16-A00-P01,1740,69,0,1671
48666,007749,ESCORREDOR DE TALHERES  - 22 X 14 X 12 CM,PLASUTIL,Em linha,R31-B07-A01-P03,834,53,0,781
48670,001093,LIXEIRA C/ PEDAL TRAMA  7 LTS,PLASUTIL,Em linha,R33-B07-A02-P03,116,6,0,110
48669,001096,LIXEIRA C/ PEDAL TRAMA  12 LTS,PLASUTIL,Em linha,R29-B10-A02-P03,96,1,0,95
48655,003287,CESTO DE ROUPAS TRAMA 40 L FENDI,PLASUTIL,Em linha,R31-B09-A02-P02,69,0,0,69
16419,005708,CJ MANTIMENTO ROSCA C/ 05 PCS,PLASUTIL,Promocao,R32-B03-A00-P01,135,0,0,135
32124,008048,PORTA ACUCAR VINTAGE 1800 ML,PLASUTIL,Promocao,R30-B05-A00-P02,226,27,0,199
32123,008047,PORTA CAFE VINTAGE 1800 ML,PLASUTIL,Promocao,R30-B05-A00-P01,257,27,0,230
12937,005598,"POTE ALTO RETANG 2 DIV 1,1 LTS CAFE DA MANHA",PLASUTIL,Promocao,R32-B05-A00-P02,445,12,240,433
46784,003630,"POTE ROSCA 1,8L ARROZ",PLASUTIL,Em linha,R32-B10-A00-P01,303,9,0,294
46787,003624,"POTE ROSCA 1,8L FEIJAO",PLASUTIL,Em linha,R32-B10-A00-P03,381,13,0,368
34592,008170,"POTE ROSCA 1,8L SAL GROSSO",PLASUTIL,Em linha,R30-B09-A00-P01,177,3,0,174
46785,008171,"POTE ROSCA 1,8L ERVA MATE",PLASUTIL,Em linha,R32-B10-A00-P02,247,3,0,244
46786,009846,"POTE ROSCA 1,8L FARINHA",PLASUTIL,Em linha,R32-B09-A00-P02,271,9,0,262
28633,006400,"POTE ROSCA 1,8L ACUCAR",PLASUTIL,Em linha,R30-B04-A00-P02,922,45,0,877
28632,006399,"POTE ROSCA 1,8L CAFE",PLASUTIL,Em linha,R30-B04-A00-P01,1067,33,0,1034
56050,13999,POTE ROSCA 720 ML ACHOCOLATADO,PLASUTIL,Em linha,R30-B08-A00-P03,330,10,0,320
56052,14001,POTE ROSCA 720 ML SAL,PLASUTIL,Em linha,R30-B07-A00-P02,246,11,0,235
11250,002803,PORTA METADE CEBOLA E ALHO 500 ML,PLASUTIL,Em linha,R31-B07-A01-P01,1035,84,0,951
56030,7895,PORTA MIX ALHO - 11 X 6 CM,PLASUTIL,Em linha,R30-B10-A01-P03,1282,44,210,1238
56031,7896,PORTA MIX CEBOLA - 11 X 6 CM,PLASUTIL,Em linha,R30-B10-A01-P04,1790,66,140,1724
56032,7897,PORTA MIX CHEIRO VERDE - 11 X 6 CM,PLASUTIL,Em linha,R30-B09-A01-P05,1299,39,0,1260
15202,005728,BISNAGA 250 ML CATCHUP,PLASUTIL,Em linha,R33-B09-A01-P01,1013,68,0,945
15203,005729,BISNAGA 250 ML MOSTARDA,PLASUTIL,Em linha,R33-B09-A01-P02,639,38,0,601
15206,005748,BISNAGA 250 ML MAIONESE,PLASUTIL,Em linha,R33-B09-A01-P03,1099,62,0,1037
46989,007756,ESCORREDOR DE LOUCAS,PLASUTIL,Em linha,R30-B06-A00-P02,42,3,120,39
54825,9896,CJ MANTIMENTO ROSCA CLIC 05 PCS VERMELHO,PLASUTIL,Em linha,R32-B08-A00-P01,481,0,0,481
46986,003646,JARRA FILTRA GELO 5 LTS,PLASUTIL,Em linha,R30-B10-A00-P01,481,0,0,481
46985,003645,JARRA FILTRA GELO 2LTS,PLASUTIL,Em linha,R30-B10-A00-P02,486,9,0,477
54837,3651,JARRA GRADUADA C/ ESPREMEDOR 1L,PLASUTIL,Em linha,R30-B10-A00-P03,392,6,0,386
46988,007792,FUNIL GRANDE,PLASUTIL,Promocao,R30-B04-A01-P01,686,40,0,646
33037,006574,BISNAGA CONFEITAR C/ 05 BICOS,PLASUTIL,Promocao,R33-B09-A01-P03,622,0,0,622
56940,12981,KIT PORTA DETERGENTE 600 ML C/ RODO - VERMELHO,PLASUTIL,Lancamento,R32-B13-A00-P03,557,16,0,541
46990,007766,PORTA DETERGENTE COMPLETO VERMELHO 600 ML,PLASUTIL,Em linha,R33-B15-A00-P01,860,63,160,797
11276,002978,"RODINHO DE PIA 23,5 CM VERMELHO",PLASUTIL,Promocao,R30-B08-A01-P03,223,24,0,199
5520,002186,RODINHO DE PIA 16 CM VERMELHO,PLASUTIL,Promocao,R31-B09-A00-P01,3412,241,360,3171
10895,002977,"RODINHO DE PIA 13,5 CM VERMELHO",PLASUTIL,Em linha,R32-B02-A00-P01,7227,216,0,7011
54815,9608,AMASSADOR DE LEGUMES - 24 CM,PLASUTIL,Promocao,R30-B08-A01-P01,910,51,0,859
33028,006772,"FORMA P/ MOLDAR HAMBURGUER  13,9X11,7X3,3 CMS",PLASUTIL,Promocao,R29-B05-A01-P01,638,18,0,620
54843,2452,POTE GELATINA DIVERTIDOS 6 PÇS,PLASUTIL,Em linha,R30-B07-A01-P01,170,0,0,170
33026,006527,SORVETEIRA C/ RECHEIO  04 PCS,PLASUTIL,Em linha,R30-B02-A02-P02,288,0,0,288
10647,004115,CJ MANTIMENTO ROSCA CLIC 05 PCS BRANCO,PLASUTIL,Em linha,R32-B04-A00-P01,136,6,0,130
11449,004972,CJ PORTA MANTIMENTOS ROSCA MEDIO 05 PCS,PLASUTIL,Em linha,R32-B03-A00-P02,99,3,0,96
9669,002616,POTE CLIC C/ROSCA 300 ML,PLASUTIL,Em linha,R31-B05-A00-P03,1724,60,0,1664
9667,002613,POTE CLIC C/ROSCA 720 ML,PLASUTIL,Em linha,R30-B08-A00-P01,231,48,180,183
10175,004646,POTE CLIC C/ROSCA 900 ML,PLASUTIL,Em linha,R31-B05-A00-P01,968,24,0,944
38077,008045,ORGANIZADOR C/ TPA ROSCA 3PÇS,PLASUTIL,Promocao,R30-B10-A02-P01,854,45,200,809
9668,002614,POTE CLIC C/ROSCA ALTO 01 LT,PLASUTIL,Em linha,R30-B08-A00-P02,733,18,0,715
10483,004648,"POTE CLIC C/ROSCA 2,6 LTS",PLASUTIL,Em linha,R31-B05-A00-P02,197,6,0,191
12633,003838,PORTA TALHERES LUDICO 04 DIV - 32 X 23 X 58 CM,PLASUTIL,Em linha,R29-B08-A01-P01,248,23,80,225
12634,003839,"PORTA TALHERES LUDICO 05 DIV - 37 X 29,5 X 5,8 CM",PLASUTIL,Em linha,R30-B03-A00-P02,332,14,240,318
2413,000156,FORMA P/ GELO,PLASUTIL,Em linha,R30-B10-A01-P01,1119,46,1212,1073
54834,277,FUNIL 11 CM BRANCO,PLASUTIL,Em linha,R30-B04-A01-P02,1327,115,300,1212
56040,13289,PORTA LEITE DE SAQUINHO - 15 X 8 X 16 CM,PLASUTIL,Em linha,R31-B01-A01-P01,535,41,300,494
9954,002696,SERVE PAO,PLASUTIL,Em linha,R30-B06-A01-P01,319,12,0,307
9331,002506,POTE CLIC BISCOITO,PLASUTIL,Em linha,R32-B06-A00-P02,333,12,0,321
56417,013902,FORMA P/ MOLDAR ALMONDEGA,PLASUTIL,Promocao,R29-B05-A01-P02,72,0,0,72
2399,000642,"TÁBUA MAXI-CORTE 511 X 408 X 6,7 MM",PLASUTIL,Em linha,R30-B01-A00-P01,57,1,0,56
56420,006539,PORTA ESPAGUETE DEC C/TP DOSADORA - 9X29CM,PLASUTIL,Em linha,R30-B10-A02-P02,401,14,0,387
10643,002888,GALHETEIRO PORTA BISNAGAS SAL E PALITO,PLASUTIL,Em linha,R33-B05-A02-P02,71,0,30,71
11410,002989,PORTA GUARDANAPO 185X115X68 MM,PLASUTIL,Em linha,R30-B04-A01-P03,699,42,0,657
10891,002850,"CESTINHA EMPILHAVEL 25,5 X 24,2 X 6 CM",PLASUTIL,Promocao,R30-B05-A00-P03,1275,39,0,1236
54820,2848,"CESTINHA EMPILHÁVEL 14,5 X 13,7 X 6 CM",PLASUTIL,Em linha,R32-B05-A00-P03,1046,72,360,974
9507,002610,PORTA CONDIMENTOS 07 PCS,PLASUTIL,Em linha,R30-B02-A01-P01,244,3,0,241
9968,004653,FARINHEIRA/ACUCAREIRO C/ BICO,PLASUTIL,Em linha,R31-B08-A01-P01,378,18,150,360
56939,12857,KIT PORTA DETERGENTE 600 ML C/ RODO - BRANCO,PLASUTIL,Lancamento,R32-B13-A00-P02,950,12,0,938
54826,9913,PORTA DETERGENTE COMPLETO BRANCO 600 ML,PLASUTIL,Em linha,R33-B14-A00-P01,372,35,120,337
5000,001275,PORTA DETERGENTE,PLASUTIL,Em linha,R30-B03-A01-P04,550,19,300,531
10476,002632,PORTA DETERGENTE COMPACTO,PLASUTIL,Em linha,R31-B05-A01-P02,890,60,240,830
56942,13827,RODINHO DE PIA 16 CM BRANCO,PLASUTIL,Lancamento,R31-B10-A00-P01,2382,78,0,2304
2369,001188,PENEIRA 07 CM,PLASUTIL,Em linha,R31-B08-A00-P02,914,36,480,878
2370,001189,PENEIRA 12 CM,PLASUTIL,Promocao,R31-B08-A00-P03,573,6,0,567
2371,001190,PENEIRA 16 CM,PLASUTIL,Em linha,R31-B08-A00-P04,395,6,0,389
2372,001191,PENEIRA 19 CM,PLASUTIL,Em linha,R31-B08-A00-P01,301,0,0,301
51104,009164,PENEIRA FUNIL 29 CM BRANCA,PLASUTIL,Em linha,R31-B07-A00-P01,255,0,0,255
34011,006670,CJ MANTIMENTO ROSCA BORBOLETA C/ 05 PCS ,PLASUTIL,Em linha,R29-B01-A00-P01,386,25,0,361
46751,003713,CJ MANTIMENTO ROSCA BORBOLETA C/ 03 PCS,PLASUTIL,Em linha,R32-B03-A00-P03,83,8,60,75
56039,13254,PORTA ESPAGUETE BORBOLETA C/TP DOSADORA - 9X29CM,PLASUTIL,Em linha,R30-B09-A02-P03,897,386,800,511
48681,003877,"POTE ROSCA 1,4 L BORBOLETA",PLASUTIL,Em linha,R31-B06-A00-P01,292,9,0,283
48684,003873,POTE ROSCA 900 ML BORBOLETA,PLASUTIL,Em linha,R31-B06-A00-P02,404,11,0,393
34035,003872,POTE ROSCA 300 ML BORBOLETA,PLASUTIL,Em linha,R31-B08-A01-P03,1095,12,900,1083
52456,006741,POTE RETANGULAR 1L C/ 2 DIV BORBOLETA,PLASUTIL,Em linha,R30-B02-A01-P04,618,53,0,565
48680,004354,POTE CLIC RETANGULAR 620 ML BORBOLETA,PLASUTIL,Em linha,R30-B09-A01-P01,215,33,0,182
34037,006698,SALEIRO BORBOLETA 01 LT,PLASUTIL,Promocao,R31-B07-A02-P01,1579,471,1200,1108
7693,002210,PORTA FILTRO PARA CAFE,PLASUTIL,Em linha,R30-B07-A00-P01,1361,30,0,1331
34013,006687,ESCORREDOR TALHERES BORBOLETA - 17 X 15 X 14 CM,PLASUTIL,Promocao,R31-B06-A02-P03,739,28,360,711
56419,013990,JARRA 870 ML C/ ESPREMEDOR PLUG BORBOLETA,PLASUTIL,Em linha,R30-B09-A00-P02,380,17,60,363
56418,013537,JARRA 560 ML C/ ESPREMEDOR PLUG BORBOLETA,PLASUTIL,Em linha,R30-B09-A00-P03,200,9,60,191
50067,012872,PENEIRA FUNIL 19 CM BORBOLETA,PLASUTIL,Em linha,R31-B07-A00-P02,406,32,80,374
50066,012873,PENEIRA FUNIL 29 CM BORBOLETA,PLASUTIL,Em linha,R31-B07-A00-P03,143,24,60,119
46980,007785,"SECADOR DE SALADAS 2,8 LTS",PLASUTIL,Em linha,R32-B07-A02-P01,244,13,0,231
46979,007782,SECADOR DE SALADAS 04 LTS,PLASUTIL,Em linha,R32-B07-A02-P02,111,9,0,102
46966,006178,RODINHO DE PIA 16 CM BORBOLETA,PLASUTIL,Em linha,R31-B09-A00-P02,1193,164,600,1029
56027,6693,"SERVE PAO BORBOLETA - 34 X 19,3 X 15 CM",PLASUTIL,Em linha,R31-B05-A01-P01,223,12,0,211
56026,6692,"BOLEIRA RED BORBOLETA C/ ALCA E ROSCA - 28,5X12CM",PLASUTIL,Em linha,R29-B03-A02-P01,279,1,0,278
56028,6703,QUEIJEIRA ROSCA BORBOLETA - 21 X 9 CM,PLASUTIL,Em linha,R29-B01-A02-P02,567,18,0,549
34017,004492,PORTA CONDIMENTOS BORBOLETA 07 PCS,PLASUTIL,Em linha,R30-B01-A02-P02,379,12,0,367
56037,9589,PORTA OVOS DUZIA BORBOLETA - 30 X 12 X 7 CM,PLASUTIL,Em linha,R30-B05-A01-P02,357,0,0,357
56029,6759,PORTA BISCOITO/TORRADA BORBOLETA - 21 X 10 X 12 CM,PLASUTIL,Em linha,R32-B06-A00-P01,278,2,0,276
56025,6177,CANECA 360 ML BORBOLETA,PLASUTIL,Em linha,R32-B09-A01-P04,315,6,80,309
50050,012896,GARRAFA C/ BOMBA 280 ML DETERGENTE BORBOLETA,PLASUTIL,Em linha,R33-B05-A01-P01,508,2,0,506
46781,006802,PORTA DETERGENTE C/ PRESS 540 ML,PLASUTIL,Promocao,R32-B09-A00-P01,422,2,0,420
50047,012780,PORTA DETERGENTE COMPLETO ROSA 600 ML,PLASUTIL,Em linha,R33-B13-A00-P01,846,342,800,504
56938,12983,KIT PORTA DETERGENTE 600 ML C/ RODO - ROSA PASTEL,PLASUTIL,Lancamento,R32-B13-A00-P01,1001,446,720,555
34015,006685,"LIXEIRA BASCULANTE BORBOLETA 11,8 LTS",PLASUTIL,Em linha,R29-B08-A02-P02,143,8,0,135
34016,006684,"LIXEIRA PIA BASCULANTE BORBOLETA 4,9 LTS",PLASUTIL,Em linha,R29-B07-A02-P02,329,15,0,314
48665,006686,ESCORREDOR DE LOUÇAS ROSA BORBOLETA - 45X35X10 CM,PLASUTIL,Em linha,R33-B08-A02-P02,81,1,0,80
45273,003446,PORTA SAB. LIQUIDO 360ML TRAMA ROSA,PLASUTIL,Em linha,R33-B09-A00-P01,726,15,200,711
45272,003430,PORTA ESCOVA 770ML TRAMA ROSA,PLASUTIL,Em linha,R33-B10-A00-P01,718,23,80,695
46975,007886,PORTA SAB. LIQUIDO 250 ML,PLASUTIL,Em linha,R31-B06-A02-P01,760,48,0,712
46982,007887,PORTA ESCOVA / CREME DENTAL,PLASUTIL,Em linha,R29-B06-A02-P01,838,24,0,814
46750,009868,CESTO P/ PRENDEDOR TRAMA ROSA - 21 X 17 X 8 CM,PLASUTIL,Promocao,R32-B10-A01-P01,233,1,0,232
11426,004170,PROTETOR LAVA ROUPAS FINAS,PLASUTIL,Em linha,R32-B08-A02-P02,244,0,0,244
45278,003510,CESTA RETANGULAR TRAMA ROSA - 17X13 CM - 990ML,PLASUTIL,Promocao,R29-B10-A01-P01,535,5,0,530
45279,001751,"CESTA RETANGULAR TRAMA ROSA - 26X16 CM - 2,1L",PLASUTIL,Em linha,R33-B05-A02-P03,635,4,0,631
45280,001571,"CESTA RETANGULAR TRAMA ROSA - 34X25 CM - 5,8L",PLASUTIL,Em linha,R31-B03-A02-P01,137,2,0,135
48653,000232,"CAIXA TRAMA C/ TAMPA 2,8L ROSA",PLASUTIL,Em linha,R33-B05-A02-P01,101,5,120,96
45290,000233,"CAIXA TRAMA C/ TAMPA 4,7L ROSA",PLASUTIL,Em linha,R31-B02-A02-P03,115,6,0,109
45289,000236,"CAIXA TRAMA C/ TAMPA 8,0L ROSA",PLASUTIL,Em linha,R31-B02-A02-P02,111,6,0,105
45288,000237,CAIXA TRAMA C/ TAMPA 14L ROSA,PLASUTIL,Em linha,R31-B02-A02-P01,112,6,0,106
45271,003059,"CESTA REDONDA TRAMA ROSA C/ ALÇAS 25,5L",PLASUTIL,Em linha,R32-B05-A00-P01,61,4,0,57
45276,001094,LIXEIRA C/ PEDAL TRAMA ROSA 7 LTS,PLASUTIL,Em linha,R33-B07-A02-P02,84,7,0,77
45275,001097,LIXEIRA C/ PEDAL TRAMA ROSA 12 LTS,PLASUTIL,Em linha,R29-B09-A02-P03,58,0,0,58
45274,003425,CESTO DE ROUPAS TRAMA 40L ROSA,PLASUTIL,Em linha,R31-B09-A02-P03,64,3,0,61
56411,013792,PORTA SAB. LIQUIDO 420 ML CLASSIC,PLASUTIL,Promocao,R29-B05-A02-P01,801,23,180,778
56410,013793,"PORTA ESCOVA 380 ML CLASSIC - 7,8 X 20,5 CM",PLASUTIL,Em linha,R29-B05-A02-P02,732,36,240,696
56409,013794,"PORTA COTONETE/ALGODAO CLASSIC - 7,5X11 CM",PLASUTIL,Em linha,R29-B06-A02-P02,334,11,0,323
56412,013795,"SABONETEIRA CLASSIC FOSCO - 10 X 7,6 X 2,2 CM",PLASUTIL,Em linha,R33-B05-A01-P02,428,8,0,420
56408,013796,"LIXEIRA CLASSIC 4,6 L",PLASUTIL,Em linha,R31-B10-A02-P01,112,5,0,107
56406,013812,PORTA SAB. LIQUIDO 420 ML CLASSIC FRISOS,PLASUTIL,Promocao,R29-B07-A01-P01,1379,458,900,921
56405,013813,"PORTA ESCOVA 380 ML CLASSIC FRISOS - 7,8 X 20,5 CM",PLASUTIL,Em linha,R29-B07-A01-P02,1018,453,1200,565
56404,013814,"PORTA COTONETE/ALGODAO CLASSIC FRISOS - 7,5X11 CM",PLASUTIL,Promocao,R29-B08-A01-P02,178,3,0,175
56407,013815,"SABONETEIRA CLASSIC FRISOS - 10 X 7,6 X 2,2 CM",PLASUTIL,Em linha,R33-B05-A01-P03,215,11,160,204
56403,013816,"LIXEIRA CLASSIC FRISOS 4,6 L",PLASUTIL,Em linha,R31-B10-A02-P02,80,5,0,75
54835,9476,GARRAFA C/ BOMBA 280 ML - ALCOOL GEL,PLASUTIL,Em linha,R29-B01-A01-P01,697,0,0,697
39506,009828,PORTA SAB. LIQUIDO 360ML,PLASUTIL,Em linha,R31-B05-A02-P01,400,15,0,385
39503,009835,PORTA ESCOVA 430ML,PLASUTIL,Em linha,R31-B05-A02-P02,401,11,0,390
54836,12979,GARRAFA C/ BOMBA 280 ML - ALCOOL GEL CASA DE BANHO,PLASUTIL,Em linha,R31-B07-A02-P03,582,0,240,582
39505,004458,PORTA SAB. LIQUIDO 360ML DEC CASA DE BANHO,PLASUTIL,Em linha,R31-B06-A02-P02,815,12,0,803
39504,004457,PORTA ESCOVA 430ML DEC CASA DE BANHO,PLASUTIL,Em linha,R29-B09-A01-P01,541,14,0,527
54847,12855,PULVERIZADOR 1L CLÁSSICO JARDIM HIDRATAR,PLASUTIL,Em linha,R30-B08-A02-P01,530,0,0,530
30357,006597,PULVERIZADOR DECORADO 580 ML,PLASUTIL,Em linha,R30-B07-A02-P02,1500,45,0,1455
50079,007996,PULVERIZADOR 300 ML DECORADO,PLASUTIL,Promocao,R32-B08-A02-P01,511,1,300,510
51108,012917,PULVERIZADOR CLÁSSICO 1L,PLASUTIL,Em linha,R30-B10-A02-P03,259,4,0,255
28631,004861,PULVERIZADOR 580 ML,PLASUTIL,Promocao,R29-B09-A00-P01,5364,282,1600,5082
48685,009793,PULVERIZADOR 300 ML,PLASUTIL,Em linha,R29-B10-A00-P01,5275,361,2400,4914
52455,007893,PORTA SABAO EM PO 1 KG ROSA,PLASUTIL,Em linha,R29-B02-A02-P03,159,4,60,155
26909,006288,PORTA SABAO EM PO DECORADO 1440 ML,PLASUTIL,Em linha,R29-B02-A02-P03,262,6,0,256
12914,004400,BALDE 8 LTS,PLASUTIL,Em linha,R30-B01-A00-P02,171,3,0,168
12915,004401,BALDE 12 LTS,PLASUTIL,Em linha,R30-B01-A00-P03,106,3,0,103
10475,002891,"CAIXA 9,3 LTS GRAN BOX BAIXA - 40,5X29X12,2 CMS ",PLASUTIL,Em linha,R32-B01-A01-P02,139,1,0,138
10471,002771,"CAIXA 13,7 LTS GRAN BOX BAIXA - 45,7X32,6X13,8 CMS",PLASUTIL,Em linha,R32-B03-A01-P01,159,2,0,157
10472,002772,"CAIXA 26,5 LTS GRAN BOX BAIXA - 55,5X40,3X18,1 CMS",PLASUTIL,Em linha,R32-B02-A01-P01,199,0,0,199
10474,002890,"CAIXA 19,8 LTS GRAN BOX ALTA - 40,5X29X24,5 CMS",PLASUTIL,Em linha,R32-B01-A01-P03,113,0,0,113
10468,002759,"CAIXA 29 LTS GRAN BOX ALTA - 45,7X32,6X28 CMS",PLASUTIL,Em linha,R32-B04-A01-P01,160,2,0,158
10469,002760,"CAIXA 56 LTS GRAN BOX ALTA - 55,5X40,3X36,5 CMS",PLASUTIL,Em linha,R32-B04-A01-P02,124,0,0,124
10473,002773,"CAIXA 38 LTS GRAN BOX BAIXA - 63,5X45,3X19,8 CMS",PLASUTIL,Em linha,R32-B02-A01-P02,86,0,0,86
10470,002761,"CAIXA 78 LTS GRAN BOX ALTA - 63,5X45,3X40,1 CMS",PLASUTIL,Em linha,R32-B03-A01-P02,108,0,30,108
56038,13206,CESTA DOBRAVEL ECO - 52 X 36 X 30 CM,PLASUTIL,Em linha,R30-B02-A00-P02,27,0,0,27
35553,008168,CJ CONECTS POTE QUADR C/ 3 PCS,PLASUTIL,Em linha,R29-B03-A00-P01,218,4,0,214
34651,008075,CJ CONECTS POTE QUADR C/ 6 PCS,PLASUTIL,Em linha,R29-B10-A02-P02,242,4,0,238
34650,008244,CJ CONECTS POTE RETANG C/ 5 PCS,PLASUTIL,Em linha,R29-B10-A02-P01,275,3,0,272
35552,008074,CJ CONECTS POTE QUADR C/ 4 PCS,PLASUTIL,Promocao,R30-B09-A01-P02,231,6,0,225
51113,009533,KIT GIRE E TRAVE 155 ML - 76 PEÇAS FENDI,PLASUTIL,Promocao,R31-B07-A02-P02,31,1,0,30
56936,8743,KIT GIRE E TRAVE 155 ML - 76 PEÇAS VERMELHO,PLASUTIL,Lancamento,R30-B01-A02-P01,33,1,0,32
51114,009534,KIT GIRE E TRAVE 380 ML - 38 PEÇAS FENDI,PLASUTIL,Promocao,R31-B08-A02-P03,43,3,0,40
56937,9528,KIT GIRE E TRAVE 380 ML - 38 PEÇAS VERMELHO,PLASUTIL,Lancamento,R30-B01-A02-P03,33,2,0,31
16409,003494,LIXEIRA ECOBLACK C/ PEDAL 07 LTS,PLASUTIL,Em linha,R31-B02-A00-P02,856,33,300,823
16410,003495,LIXEIRA ECOBLACK C/ PEDAL 14 LTS,PLASUTIL,Em linha,R31-B01-A00-P01,603,21,120,582
40519,003496    ,LIXEIRA ECOBLACK C/ PEDAL 30 LTS - 3 EM 1,PLASUTIL,Em linha,R33-B08-A02-P01,395,12,0,383
16411,003497,LIXEIRA ECOBLACK C/ PEDAL 48 LTS,PLASUTIL,Em linha,R31-B08-A02-P01,257,6,0,251
16402,003484,"LIXEIRA ECOBLACK PIA 4,9 LTS",PLASUTIL,Em linha,R33-B10-A02-P01,1233,66,1000,1167
16406,003485,"LIXEIRA ECOBLACK BASCULANTE 7,2 LTS",PLASUTIL,Em linha,R31-B02-A00-P01,880,63,120,817
16407,003486,"LIXEIRA ECOBLACK BASCULANTE 11,8 LTS",PLASUTIL,Em linha,R33-B07-A02-P01,535,22,120,513
16404,003475,LIXEIRA ECOBLACK BASCULANTE PISO 46 LTS,PLASUTIL,Em linha,R33-B09-A02-P02,135,1,0,134
16403,003474,"LIXEIRA ECOBLACK BASCULANTE 35,4 LTS",PLASUTIL,Em linha,R33-B09-A02-P01,202,0,0,202
16408,003487,"LIXEIRA ECOBLACK BASCULANTE 23,2 LTS",PLASUTIL,Em linha,R33-B10-A02-P02,230,2,0,228
20223,004739,"PA C/ ALCA ARTICULAVEL - 25X22,5X80CM",PLASUTIL,Promocao,R29-B09-A01-P02,144,5,0,139
9355,002496,LIXEIRA ECOBLACK GIRA TOP 15 LTS Nº 02,PLASUTIL,Em linha,R31-B04-A02-P01,115,8,0,107
7689,000463,LIXEIRA ECOBLACK FLIP TOP PISO 32 LTS,PLASUTIL,Em linha,R29-B04-A02-P02,98,1,0,97
14184,003732,"LIXEIRA PIA STOP 4,9 LTS",PLASUTIL,Em linha,R29-B07-A02-P01,168,0,0,168
8900,002413,LIXEIRA C/ PEDAL PRATICA 07 LTS,PLASUTIL,Promocao,R29-B08-A02-P01,271,12,0,259
7694,002273,LIXEIRA C/ PEDAL PRATICA 14 LTS,PLASUTIL,Promocao,R32-B01-A01-P01,149,4,0,145
38080,000461,"LIXEIRA FLIP TOP PIA 3,7 LTS",PLASUTIL,Em linha,R29-B03-A02-P02,189,0,0,189
1907,000462,"LIXEIRA FLIP TOP PISO 9,3 LTS",PLASUTIL,Em linha,R29-B04-A02-P02,73,2,0,71
8399,002276,LIXEIRA C/ PEDAL E RODAS 83 LTS,PLASUTIL,Em linha,R31-B03-A02-P02,26,2,15,24
8398,002275,LIXEIRA C/ PEDAL PRATICA 48 LTS,PLASUTIL,Em linha,R31-B04-A02-P02,97,3,0,94
11428,002979,LIXEIRA C/ PEDAL 30 LTS,PLASUTIL,Em linha,R31-B03-A02-P03,232,4,0,228
48404,25603PM,CAIXA RATTAN 40L PRETO,ARQPLAST,Em linha,R36-B16-A00-P01,1510,61,0,1449
48403,25598PM,CAIXA RATTAN 20L PRETO,ARQPLAST,Em linha,R36-B13-A00-P01,1414,65,1200,1349
48402,25593PM,CAIXA RATTAN 15L PRETO,ARQPLAST,Em linha,R36-B14-A00-P01,1111,63,2400,1048
48401,25588PM,CAIXA RATTAN 07L PRETO,ARQPLAST,Em linha,R36-B15-A00-P01,3910,990,3000,2920
56017,25665,CESTO RATTAN 50L TAMPA BASCULADA PRETO,ARQPLAST,Em linha,R36-B17-A00-P01,308,23,210,285
35796,25425PM,ORGANIZADOR C/ TAMPA 40L PRETA - 59 X 25 X 45 CM,ARQPLAST,Em linha,R35-B02-A00-P02,203,0,0,203
35795,25429PM,ORGANIZADOR C/ TAMPA 25L PRETA - 50 X 23 X 36 CM,ARQPLAST,Em linha,R35-B02-A00-P01,161,0,0,161
21619,25167PM,ORGANIZADOR C/ TAMPA 50L - 57 X 35 X 41 CM,ARQPLAST,Em linha,R35-B09-A00-P01,444,1,0,443
21618,25166PM,ORGANIZADOR C/ TAMPA 35L - 55 X 31 X 38 CM,ARQPLAST,Em linha,R35-B09-A00-P02,181,4,120,177
21617,25165PM,ORGANIZADOR C/ TAMPA 30L - 44 X 27 X 35 CM,ARQPLAST,Em linha,R35-B10-A00-P02,133,2,240,131
52494,25467PM,ORGANIZADOR C/ TAMPA 05L NATURAL - 27 X 20 X 13 CM,ARQPLAST,Em linha,R34-B10-A01-P02,573,0,0,573
39199,25479PM,"ORGANIZADOR GAVETEIRO 3 GAVETAS - 14X19,5X16 CM",ARQPLAST,Em linha,R35-B02-A02-P02,717,0,0,717
52866,25481PM,ORGANIZADOR C/ TAMPA 05L BRANCO - 34 X 24 X 11 CM,ARQPLAST,Em linha,R34-B09-A01-P02,671,0,0,671
48414,CR12PM,CABIDE ROUPAS C/ SOLAPA 12 PCS - PRETO,ARQPLAST,Em linha,R35-B20-A00-P01,1211,39,0,1172
33195,CR06PM,CABIDE ROUPAS C/ SOLAPA 06 PCS - PRETO,ARQPLAST,Em linha,R34-B15-A00-P01,5246,278,500,4968
8923,CX52.VEPM,CAIXA DE SUP VERMELHA ( + DE 30 GRAV ),ARQPLAST,Em linha,R30-B36-A00-P01,389,0,0,389
8925,CX52.AZPM,CAIXA DE SUP AZUL ( + DE 30 GRAV ),ARQPLAST,Em linha,R30-B36-A00-P01,414,0,0,414
8924,CX52.VDPM,CAIXA DE SUP VERDE ( + DE 30 GRAV ),ARQPLAST,Em linha,R30-B36-A00-P01,186,0,150,186
10719,CX52.AMPM,"CAIXA DE SUP AMARELA (+ DE 30 GRAV)-331X36X55,5 CM",ARQPLAST,Em linha,R30-B36-A00-P01,148,0,30,148
11904,CX52.BRPM,CAIXA DE SUP BRANCA ,ARQPLAST,Em linha,R30-B36-A00-P01,125,6,120,119
35888,CX52.PTPM,CAIXA DE SUP PRETA ,ARQPLAST,Em linha,R30-B36-A00-P01,446,0,120,446
35891,25301PM,"ESTRADO PRETO 25 X 50 X 2,8 CMS",ARQPLAST,Em linha,R35-B14-A00-P01,968,0,0,968
21615,25156PM,REGADOR 05 LTS,ARQPLAST,Em linha,R34-B08-A01-P01,2254,114,1200,2140
21616,25157PM,REGADOR 10 LTS,ARQPLAST,Em linha,R34-B07-A01-P01,506,33,900,473
30381,25309PM,BACIA P/ PEDICURE,ARQPLAST,Em linha,R35-B10-A01-P02,750,119,120,631
31542,25322PM,BACIA P/ PEDICURE ROSA,ARQPLAST,Promocao,R35-B09-A01-P02,642,108,120,534
32521,25366PM,"MINI MALETA LADY ROSA - 7"" - 16,5 X 13 X 10 CMS",ARQPLAST,Em linha,R35-B06-A02-P02,1039,24,1200,1015
10648,MM30PM,MALETA MULTIUSO COLORIDA C/ 2 BANDEJAS,ARQPLAST,Em linha,R35-B09-A02-P01,141,0,160,141
10935,MFEPM,MALETA FEMININA C/ 02 BANDEJAS - 16 X 20 X 33 CM,ARQPLAST,Em linha,R35-B09-A02-P02,175,0,80,175
31543,25335PM,"MALETA LADY BOX ROSA - 16,5 X 24,5 X 28,5 CM",ARQPLAST,Em linha,R35-B07-A02-P02,772,0,0,772
32523,25380PM,"MALETA COMBAT 5080 PRETA - 12"" - 24 X 11 X 7 CMS",ARQPLAST,Em linha,R35-B05-A02-P01,477,6,1200,471
39197,25478PM,"MALETA ECONÔMICA - 14 X 30,5 X 17 CM",ARQPLAST,Em linha,R35-B06-A02-P01,1740,726,1200,1014
32517,25382PM,"MALETA FUTURA 6020 - 13"" - 32 X 18 X 13 CMS",ARQPLAST,Em linha,R35-B05-A01-P01,220,6,400,214
10649,MM30PPM,MALETA MULTIUSO PRETA C/ 2 BANDEJAS,ARQPLAST,Em linha,R35-B08-A02-P01,303,23,80,280
10651,MF40SPM,"MALETA P/ FERRAMENTAS S/BAND PRETA 16,5X20X37 CM ",ARQPLAST,Em linha,R35-B05-A01-P02,193,16,40,177
10650,MF40PM,MALETA P/ FERRAMENTAS C/ BANDEJA PRETA,ARQPLAST,Em linha,R35-B10-A02-P01,148,0,0,148
32518,25369PM,"MALETA NEW BOX 2010 - 15"" - 36,7 X 20 X 16 CMS",ARQPLAST,Em linha,R35-B03-A02-P02,211,0,0,211
38006,25460PM,"MALETA NEW BOX  2030 -  14""  - 35X27X27CM",ARQPLAST,Em linha,R35-B02-A02-P01,272,24,60,248
32519,25334PM,"MALETA MEGA BOX - 19"" - 47,5 X 35 X 32 CMS",ARQPLAST,Em linha,R35-B07-A02-P01,74,3,0,71
12525,25652,"TÁBUA DE CORTES  32,5 X 24,5 X 0,5 CM",ARQPLAST,Em linha,R35-B09-A01-P01,944,61,600,883
42341,25525PM,CESTO FLOR LAVA TUDO - 32 X 10 CM,ARQPLAST,Em linha,R35-B04-A01-P01,2177,88,0,2089
38007,25466PM,PIPOQUEIRA LABEL 3 LTS,ARQPLAST,Em linha,R35-B04-A01-P02,233,18,0,215
31541,25317PM,"PRATO INFANTIL MENINO 20,5 CM",ARQPLAST,Em linha,R35-B01-A01-P03,1728,48,0,1680
31540,25318PM,"PRATO INFANTIL MENINA 20,5 CM",ARQPLAST,Em linha,R35-B01-A01-P02,1700,48,0,1652
46819,25558PM,BANHEIRA INFANTIL 35L AZUL,ARQPLAST,Em linha,R36-B19-A00-P01,313,15,30,298
46818,25559PM,BANHEIRA INFANTIL 35L ROSA,ARQPLAST,Em linha,R36-B19-A00-P02,245,9,90,236
28641,25237PM,MESA INFANTIL AZUL C/ LABEL,ARQPLAST,Em linha,R35-B13-A00-P01,126,3,0,123
28639,25235PM,POLTRONA INFANTIL AZUL C/ LABEL (SUPORTA ATÉ 20 KG),ARQPLAST,Em linha,R35-B03-A00-P01,143,8,0,135
10934,PI52PM,POLTRONA INFANTIL AZUL (SUPORTA ATÉ 20 KG),ARQPLAST,Em linha,R35-B04-A00-P02,258,4,0,254
28642,25238PM,MESA INFANTIL ROSA C/ LABEL,ARQPLAST,Em linha,R35-B13-A00-P02,167,3,0,164
28640,25236PM,POLTRONA INFANTIL ROSA C/ LABEL (SUPORTA ATÉ 20 KG),ARQPLAST,Em linha,R35-B03-A00-P02,215,8,0,207
14284,PI52.RPM,POLTRONA INFANTIL ROSA  (SUPORTA ATÉ 20 KG),ARQPLAST,Em linha,R35-B04-A00-P01,223,4,0,219
32530,25390PM,MESA PLAST QUAD DESM PRETA -  89 X 89 X 71 CM,ARQPLAST,Em linha,R35-B17-A00-P01,29,0,10,29
32528,25389PM,MESA PLAST RED DESM PRETA - 94 X 71 CM,ARQPLAST,Em linha,R36-B18-A00-P01,35,0,0,35
42385,25423PM,MESA MONOBLOCO QUADRADA - PRETA - 70 CM,ARQPLAST,Em linha,R37-B17-A00-P01,126,0,30,126
42345,25422PM,MESA MONOBLOCO QUADRADA - BRANCA - 70 CM,ARQPLAST,Em linha,R37-B18-A00-P01,51,12,0,39
52487,25672PM,MESA QUADRADA DOBRAVEL PRETA 72 X 80 X 70 CM,ARQPLAST,Em linha,R36-B22-A00-P01,43,2,0,41
32527,PA.VI-PTPM,POLTRONA ADULTO VIME PRETA (SUPORTA ATÉ 154 KG),ARQPLAST,Em linha,R34-B01-A00-P01,94,0,0,94
11583,PA.VIPM,POLTRONA ADULTO VIME (SUPORTA ATÉ 154 KG),ARQPLAST,Em linha,R35-B19-A00-P01,71,0,0,71
32526,CA.VMPTPM,CADEIRA ADULTO VM BISTRO PRETA (SUPORTA ATÉ 154 KG),ARQPLAST,Em linha,R37-B19-A00-P01,271,0,210,271
15063,CA.VMPM,CADEIRA ADULTO VM BISTRO (SUPORTA ATÉ 154 KG),ARQPLAST,Em linha,R37-B19-A00-P02,64,24,0,40
52486,25671PM,CADEIRA DOBRAVEL PRETA  (SUPORTA ATÉ 110 KG),ARQPLAST,Em linha,R36-B21-A00-P01,151,0,10,151
51171,25638PM,BANQUETA COM ENCOSTO PRETA (SUPORTA ATÉ 70 KG),ARQPLAST,Em linha,R35-B06-A00-P01,178,0,0,178
51170,25633PM,BANQUETA RATTAN CINZA  (SUPORTA ATÉ 70 KG),ARQPLAST,Em linha,R35-B06-A00-P02,231,0,0,231
48410,25618PM,BANQUETA RATTAN PRETA (SUPORTA ATÉ 70 KG),ARQPLAST,Em linha,R35-B05-A00-P03,138,0,0,138
48409,25616PM,BANQUETA STEP (SUPORTA ATÉ 99 KG),ARQPLAST,Em linha,R35-B14-A00-P02,212,9,0,203
10653,BCLPM,BANQUETA CINZA (SUPORTA ATÉ 70 KG),ARQPLAST,Em linha,R37-B14-A00-P01,682,6,120,676
16437,BPTPM,BANQUETA PRETA (SUPORTA ATÉ 70 KG),ARQPLAST,Em linha,R37-B13-A00-P01,4422,1746,1500,2676
32514,25379PM,ORGANIZADOR ATENA 04 ANDARES - 59X97X30 CM,ARQPLAST,Em linha,R35-B01-A02-P01,65,0,0,65
48408,25614PM,ORG VERTICAL QUADRUPLO PRETO,ARQPLAST,Em linha,R35-B16-A00-P01,641,31,0,610
48407,25612PM,ORG VERTICAL TRIPLO PRETO,ARQPLAST,Em linha,R35-B15-A00-P01,727,17,0,710
56018,25723,BALDE 14 LITROS PARA ESFREGÃO PRETO,ARQPLAST,Em linha,R35-B08-A01-P02,929,2,0,927
56015,25664,BALDE 10 LITROS C/ BICO DUPLO PRETO,ARQPLAST,Em linha,R34-B16-A00-P01,2012,74,0,1938
8919,BC10PM,BALDE 10 LITROS PARA PEDREIRO,ARQPLAST,Promocao,R35-B10-A00-P01,4297,73,1200,4224
13223,BC12PM,BALDE 12 LITROS ESPECIAL PRETO,ARQPLAST,Em linha,R34-B07-A00-P01,6097,297,0,5800
30382,25307PM,PA P/ LIXO,ARQPLAST,Em linha,R35-B07-A01-P01,957,55,1500,902
48406,25610PM,CESTO ANGULAR 32L PRETO,ARQPLAST,Em linha,R35-B07-A00-P02,156,0,0,156
10223,CT25PM,CESTO TELADO 25 LTS,ARQPLAST,Promocao,R35-B05-A00-P02,1382,1,0,1381
9195,CT10PM,CESTO TELADO 10 LTS,ARQPLAST,Promocao,R34-B06-A01-P01,3303,78,250,3225
10654,BF30PM,BALDE 30 LITROS ALCA DE FERRO,ARQPLAST,Em linha,R34-B09-A00-P02,264,12,200,252
8914,BF20/25,BALDE 20 LITROS COM ALCA DE FERRO,ARQPLAST,Em linha,R34-B06-A00-P01,5109,203,0,4906
8915,BF15PM,BALDE 15 LITROS ALCA DE FERRO,ARQPLAST,Promocao,R34-B08-A00-P01,8427,415,3600,8012
48415,BF10PM,BALDE 10 LITROS ALCA DE FERRO,ARQPLAST,Em linha,R35-B07-A00-P01,2805,122,800,2683
8918,BF08PM,BALDE 08 LITROS ALCA DE FERRO,ARQPLAST,Em linha,R34-B10-A00-P01,12089,520,2000,11569
35895,25275PM,BACIA CANELADA 03 LTS - COLOR,ARQPLAST,Em linha,R35-B07-A01-P02,427,12,600,415
48413,25276PM,BACIA 05 LITROS,ARQPLAST,Em linha,R35-B05-A00-P01,1353,106,0,1247
8913,BA12PM,BACIA 12 LITROS COM ALCA,ARQPLAST,Em linha,R33-B04-A00-P01,2648,132,0,2516
8921,BA18PM,BACIA 18 LITROS COM ALCA,ARQPLAST,Em linha,R34-B04-A00-P02,1987,133,600,1854
9387,BA32PM,BACIA 32 LITROS COM ALCA,ARQPLAST,Em linha,R34-B05-A00-P01,2134,184,240,1950
8922,BA40PM,BACIA 40 LITROS COM ALCA,ARQPLAST,Em linha,R34-B06-A00-P02,1192,31,100,1161
13222,BA80PM,BACIA 80 LITROS EXTRA GIGANTE ,ARQPLAST,Em linha,R34-B08-A00-P02,747,20,180,727
52482,25663PM,BACIA 100 LITROS EXTRA GIGANTE,ARQPLAST,Em linha,R34-B03-A00-P01,136,3,200,133
52493,25649PM,CESTO OVAL 60 L PRETO C/ TAMPA,ARQPLAST,Em linha,R35-B21-A00-P01,402,12,0,390
46820,25570PM,CESTO OVAL 60 L PRETO,ARQPLAST,Em linha,R34-B04-A00-P01,257,7,0,250
28645,CT60BRPM,CESTO TELADO C/ TAMPA 60 LTS BRANCO,ARQPLAST,Em linha,R34-B02-A00-P01,384,18,200,366
28646,CT60PTPM,CESTO TELADO C/ TAMPA 60 LTS PRETO,ARQPLAST,Em linha,R34-B02-A00-P02,1099,58,500,1041
56966,25726,KIT P/ BANHEIRO C/ 5 PÇS PRETO,ARQPLAST,Lancamento,R34-B01-A00-P01,367,3,0,364
56965,25725,KIT P/ BANHEIRO C/ 5 PÇS BRANCO,ARQPLAST,Lancamento,R35-B03-A00-P03,385,3,0,382
56014,25722,"CANTONEIRA PRETA - 13 X 21 X 37,5 CM",ARQPLAST,Promocao,R35-B08-A01-P01,2077,452,1200,1625
48412,25577PM,ASSENTO SANITÁRIO PRATICO BRANCO,ARQPLAST,Em linha,R34-B04-A01-P01,1072,95,0,977
56963,25683,SABONETEIRA BRANCA,ARQPLAST,Lancamento,R34-B01-A00-P02,1286,38,0,1248
56964,25687,SABONETEIRA PRETA,ARQPLAST,Lancamento,R35-B01-A02-P02,1546,18,0,1528
12158,PR24PM,KIT PRENDEDOR DE ROUPA C/ 24 PCS,ARQPLAST,Em linha,R35-B01-A01-P01,2146,52,0,2094
37149,PR12PM,PRENDEDOR COM 12 UNIDADES - 80 KITS,ARQPLAST,Em linha,R35-B03-A01-P01,1258,36,480,1222
52484,25650PM,RODO 40 CM,ARQPLAST,Em linha,R34-B05-A01-P01,1976,512,1200,1464
52485,25651,CABO DE MADEIRA PARA RODO 120 CM,ARQPLAST,Em linha,R35-B08-A00-P01,2285,458,1200,1827
38002,25462PM,LIXEIRA COM LABEL INOX C/ CLICK 9 LTS,ARQPLAST,Em linha,R33-B02-A00-P02,2349,82,0,2267
38003,25461PM,LIXEIRA COM LABEL METALIZADO C/ CLICK 9 LTS,ARQPLAST,Em linha,R33-B01-A00-P01,967,61,150,906
42434,25499PM,LIXEIRA COM LABEL ROSE C/ CLICK 9 LTS,ARQPLAST,Em linha,R33-B01-A00-P03,937,47,600,890
42343,25522PM,LIXEIRA COM LABEL POA VERMELHO C/CLICK 9L,ARQPLAST,Em linha,R33-B01-A00-P02,358,14,400,344
42342,25521PM,LIXEIRA COM LABEL POA PRETO C/CLICK 9L,ARQPLAST,Em linha,R33-B01-A00-P04,481,13,0,468
37156,CL09PM,LIXEIRA COM LABEL DE INOX  9 LTS,ARQPLAST,Em linha,R34-B01-A00-P03,170,9,0,161
56016,25670,LIXEIRA P/ ESCRITORIO COM LABEL INOX 10L C/ CLICK,ARQPLAST,Em linha,R34-B03-A01-P01,651,19,0,632
42347,25529PM,LIXEIRA P/ ESCRITORIO COM LABEL INOX 10L,ARQPLAST,Em linha,R35-B05-A02-P01,450,0,0,450
28637,25266PM,LIXEIRA P/ ESCRITORIO 10 LTS ,ARQPLAST,Em linha,R35-B03-A02-P02,1094,83,0,1011
28636,25218PM,LIXEIRA P/ ESCRITORIO 10 LTS - LABEL,ARQPLAST,Promocao,R35-B03-A02-P01,1231,269,200,962
38005,25459PM,LIXEIRA DE PIA BASCULADA 2 LTS,ARQPLAST,Em linha,R34-B08-A01-P02,1929,55,0,1874
9509,CF10PM,CESTO FECHADO 10 LTS COM TAMPA,ARQPLAST,Promocao,R34-B09-A00-P03,2278,462,1500,1816
9641,CF20/25,CESTO FECHADO 20 LTS COM TAMPA,ARQPLAST,Em linha,R33-B04-A00-P03,1290,463,1200,827
38001,25469PM,CESTO COM PEDAL 7 LTS,ARQPLAST,Em linha,R34-B18-A00-P01,1984,150,720,1834
9508,CP12PM,CESTO COM PEDAL 12 LITROS,ARQPLAST,Em linha,R35-B04-A02-P01,905,53,600,852
35793,25436PM,CESTO COM PEDAL 21 LTS ,ARQPLAST,Em linha,R33-B04-A01-P01,651,24,60,627
32515,25378PM,CESTO COM PEDAL 30 LITROS  ,ARQPLAST,Em linha,R33-B03-A01-P01,460,9,90,451
37141,CF30PTPM,CESTO FECHADO 30 LTS PRETO,ARQPLAST,Em linha,R33-B03-A00-P01,968,25,160,943
37139,CF65PTPM,CESTO FECHADO 65 LTS PRETO,ARQPLAST,Em linha,R34-B14-A00-P01,1303,129,600,1174
37140,CF100R.PTPM,CESTO FECHADO 100 LTS C/RODAS - PRETO,ARQPLAST,Em linha,R35-B18-A00-P01,101,4,90,97
16435,CF120ECOPM,CESTO FECHADO ECO 120 LTS   ,ARQPLAST,Em linha,R35-B18-A00-P02,32,0,0,32
9197,CF30PM,CESTO FECHADO 30 LTS COM TAMPA,ARQPLAST,Em linha,R33-B02-A00-P01,800,36,0,764
9196,CF65PM,CESTO FECHADO 65 LTS COM TAMPA,ARQPLAST,Em linha,R34-B13-A00-P01,1291,105,360,1186
14283,CF100RPM,CESTO FECHADO 100 LTS C/ RODA,ARQPLAST,Em linha,R33-B03-A00-P02,254,1,0,253
10812,LB80PM,LIXEIRA BASCULANTE GIGANTE 80LTS,ARQPLAST,Em linha,R36-B20-A00-P01,100,1,0,99
37143,CP30BRPM,CESTO C/ SUPORTE E PEDAL 30 LTS - BRANCO,ARQPLAST,Ponta de Estoque,R35-B01-A00-P01,40,6,0,34
29568,25295PM,"VASO QUADR PRETO 12,5 LTS",ARQPLAST,Em linha,R34-B01-A01-P03,770,21,0,749
29570,25293PM,VASO QUADR PRETO 09 LTS,ARQPLAST,Promocao,R34-B01-A01-P01,939,45,900,894
29578,25299PM,"JARDINEIRA PRETA 4 LTS - 14X17,7X37,5 CM",ARQPLAST,Promocao,R35-B03-A01-P02,2007,14,0,1993
29572,25291PM,VASO RED PRETO 18 LTS,ARQPLAST,Em linha,R33-B01-A01-P02,777,22,0,755
29574,25289PM,VASO RED PRETO 09 LTS,ARQPLAST,Em linha,R34-B06-A01-P03,618,42,1200,576
29576,25297PM,"JARDINEIRA PRETA 8 LTS - 16,7X18,5X49,5 CM",ARQPLAST,Em linha,R35-B04-A01-P03,882,10,0,872
29569,25296PM,"VASO QUADR TERRA COTA 12,5 LTS",ARQPLAST,Em linha,R34-B02-A01-P02,324,4,100,320
29571,25294PM,VASO QUADR TERRA COTA 09 LTS,ARQPLAST,Promocao,R34-B01-A01-P02,762,9,1200,753
29579,25300PM,"JARDINEIRA TERRA COTA 4 LTS - 14X17,7X37,5 CM",ARQPLAST,Em linha,R35-B03-A01-P03,725,6,0,719
29573,25292PM,VASO RED TERRA COTA 18 LTS,ARQPLAST,Em linha,R33-B01-A01-P01,183,0,120,183
29575,25290PM,VASO RED TERRA COTA 09 LTS,ARQPLAST,Em linha,R34-B06-A01-P02,519,0,0,519
29577,25298PM,"JARDINEIRA TERRA COTA 8 LTS - 16,7X18,5X49,5 CM",ARQPLAST,Em linha,R35-B10-A01-P01,413,2,0,411
57187,258/P,"CESTO ORGAN JUTA 7,6L - PRETO - 34,5 X 16,5 X 14,5 CM",NITRONPLAST,Lancamento,R37-B01-A00-P03,114,0,0,114
57186,257/P,"CESTO ORGAN JUTA 3,72L - PRETO  - 27,7 X 13,2 X 11,5 CM",NITRONPLAST,Lancamento,R36-B04-A01-P02,128,0,0,128
57185,256/P,"CESTO ORGAN JUTA 1,52L - PRETO - 20,8 X 9 X 8,7 CM",NITRONPLAST,Lancamento,R36-B08-A00-P03,153,0,0,153
49977,163/P,LIXEIRA VIME C/ PEDAL 12 LTS PRETO,NITRONPLAST,Promocao,R38-B16-A00-P01,234,5,0,229
49983,047/P,CESTO ORGANIZADOR VIME PRETO,NITRONPLAST,Em linha,R36-B05-A00-P02,217,4,0,213
49965,052/P,LIXEIRA C/ PEDAL RATTAN 06 LTS - PRETO,NITRONPLAST,Promocao,R39-B15-A00-P01,460,20,0,440
49968,134/P,"LIXEIRA DE PIA BASCULANTE RATTAN 4,5L PRETO",NITRONPLAST,Promocao,R37-B09-A02-P01,313,21,0,292
57190,214/P,ORGANIZADOR RATTAN 6 DIVISÓRIAS PRETO,NITRONPLAST,Lancamento,R37-B06-A00-P01,387,9,0,378
49971,041/P,ORGANIZA MULTIUSO RATTAN PRETO,NITRONPLAST,Promocao,R36-B10-A02-P01,1918,481,0,1437
49974,133/P,PORTA DETERGENTE RATTAN C/ BASE PRETO,NITRONPLAST,Em linha,R36-B04-A02-P03,1794,474,0,1320
52655,254/P,GAVETEIRO MODULAR RATTAN PRETO 32 X 14 X 26 CM,NITRONPLAST,Em linha,R36-B05-A02-P03,89,0,0,89
51173,069/P,CESTO ORGAN RATTAN C/TP 16LT- PRETO - 28X38X19,NITRONPLAST,Em linha,R37-B01-A02-P01,111,0,0,111
51174,068/P,CESTO ORGAN RATTAN C/TP 8 LT- PRETO - 32X22X15,NITRONPLAST,Em linha,R36-B02-A02-P03,135,2,0,133
51175,062/P,"CESTO ORGAN RATTAN C/TP 5,5 L - PRETO - 25X10X20",NITRONPLAST,Em linha,R37-B07-A02-P02,148,0,0,148
51176,065/P,CESTO ORGAN RATTAN C/TP 2 L - PRETO - 15X9X20,NITRONPLAST,Em linha,R37-B03-A02-P03,301,0,0,301
55033,258/M,"CESTO ORGAN JUTA 7,6L - MARROM",NITRONPLAST,Em linha,R37-B01-A00-P01,412,0,0,412
55032,257/M,"CESTO ORGAN JUTA 3,72L - MARROM",NITRONPLAST,Em linha,R37-B01-A01-P02,216,0,0,216
55031,256/M,"CESTO ORGAN JUTA 1,52L - MARROM",NITRONPLAST,Promocao,R37-B01-A00-P03,339,0,0,339
49979,163/M,LIXEIRA VIME C/ PEDAL 12 LTS MARROM,NITRONPLAST,Promocao,R38-B17-A00-P01,169,0,0,169
49985,047/M,CESTO ORGANIZADOR VIME MARROM,NITRONPLAST,Em linha,R36-B05-A00-P01,223,0,0,223
49967,052/M,LIXEIRA C/ PEDAL RATTAN 06 LTS - MARROM,NITRONPLAST,Promocao,R39-B14-A00-P01,336,3,0,333
49970,134/M,"LIXEIRA DE PIA BASCULANTE RATTAN 4,5L MARROM",NITRONPLAST,Promocao,R37-B08-A02-P02,199,15,0,184
57189,214/M,ORGANIZADOR RATTAN 6 DIVISÓRIAS MARROM,NITRONPLAST,Lancamento,R36-B10-A00-P03,229,0,0,229
49973,041/M,ORGANIZA MULTIUSO RATTAN MARROM,NITRONPLAST,Promocao,R36-B10-A02-P03,1925,451,0,1474
49976,133/M,PORTA DETERGENTE RATTAN C/ BASE MARROM,NITRONPLAST,Em linha,R36-B04-A02-P02,1647,463,0,1184
52656,254/M,GAVETEIRO MODULAR RATTAN MARRON 32 X 14 X 26 CM,NITRONPLAST,Em linha,R36-B05-A02-P02,60,3,0,57
49955,069/M,CESTO ORGAN RATTAN C/TP 16LT- MARROM - 28X38X19,NITRONPLAST,Em linha,R36-B02-A02-P02,116,3,0,113
49964,068/M,CESTO ORGAN RATTAN C/TP 8 LT-MARROM - 32X22X15,NITRONPLAST,Em linha,R36-B05-A02-P01,157,3,0,154
49958,062/M,"CESTO ORGAN RATTAN C/TP 5,5 L - MARROM - 25X10X20",NITRONPLAST,Em linha,R37-B09-A02-P02,147,3,0,144
49961,065/M,CESTO ORGAN RATTAN C/TP 2 L - MARROM,NITRONPLAST,Em linha,R36-B06-A02-P02,295,3,0,292
55027,258/B,"CESTO ORGAN JUTA 7,6L - BRANCO",NITRONPLAST,Em linha,R37-B01-A01-P03,548,0,0,548
55026,257/B,"CESTO ORGAN JUTA 3,72L - BRANCO",NITRONPLAST,Em linha,R37-B01-A01-P01,596,0,0,596
55025,256/B,"CESTO ORGAN JUTA 1,52L - BRANCO",NITRONPLAST,Promocao,R37-B01-A00-P02,377,0,0,377
49978,163/B,LIXEIRA VIME C/ PEDAL 12 LTS BRANCO,NITRONPLAST,Promocao,R39-B16-A00-P01,192,0,0,192
49984,047/B,CESTO ORGANIZADOR VIME BRANCO,NITRONPLAST,Em linha,R36-B05-A00-P04,116,0,0,116
49966,052/B,LIXEIRA C/ PEDAL RATTAN 06 LTS - BRANCO,NITRONPLAST,Promocao,R39-B13-A00-P01,512,33,0,479
49969,134/B,"LIXEIRA DE PIA BASCULANTE RATTAN 4,5L BRANCO",NITRONPLAST,Promocao,R37-B08-A02-P01,211,15,0,196
49972,041/B,ORGANIZA MULTIUSO RATTAN BRANCO,NITRONPLAST,Promocao,R36-B10-A02-P02,1832,450,0,1382
49975,133/B,PORTA DETERGENTE RATTAN C/ BASE BRANCO,NITRONPLAST,Em linha,R36-B04-A02-P01,1536,463,0,1073
52657,254/B,GAVETEIRO MODULAR RATTAN BRANCO 32 X 14 X 26 CM,NITRONPLAST,Em linha,R36-B02-A02-P01,76,0,0,76
57188,214/B,ORGANIZADOR RATTAN 6 DIVISÓRIAS BRANCO,NITRONPLAST,Lancamento,R36-B10-A00-P02,277,0,0,277
49953,069/B,CESTO ORGAN RATTAN C/TP 16 LT- BRANCO - 28X38X19,NITRONPLAST,Em linha,R36-B01-A02-P02,165,4,0,161
49963,068/B,CESTO ORGAN RATTAN C/TP 8 LT- BRANCO - 32X22X15,NITRONPLAST,Em linha,R37-B07-A02-P03,141,8,0,133
49956,062/B,"CESTO ORGAN RATTAN C/TP 5,5 L - BRANCO - 25X10X20",NITRONPLAST,Em linha,R37-B09-A02-P03,219,7,0,212
49959,065/B,CESTO ORGAN RATTAN C/TP 2 L - BRANCO,NITRONPLAST,Em linha,R36-B06-A02-P01,276,9,0,267
57191,170/R,FRASQUEIRA FASHION - ROSA - 22 X 40 X 18 CM,NITRONPLAST,Lancamento,R36-B01-A00-P02,67,0,0,67
30407,218,"FRASQUEIRA RATTAN TRAD COLOR - 32,5 X 23 X 21 CM",NITRONPLAST,Em linha,R37-B10-A02-P01,43,0,0,43
11852,171,"FRASQUEIRA MEGA LUXO - 25,2 X 37 X 22 CM",NITRONPLAST,Em linha,R37-B05-A02-P01,59,7,0,52
11851,170,"CAIXA DE FERRAMENTA G ""16"" - 22,3 X 403 X 18,3 CM",NITRONPLAST,Em linha,R37-B08-A00-P03,163,0,0,163
33169,186,"FRASQUEIRA MEGA LUXO MEDIC - 25,2 X 37 X 22 CMS",NITRONPLAST,Em linha,R36-B09-A02-P02,69,0,0,69
10417,126,"FRASQUEIRA GRANDE FEMININA - 19,8 X 28 X 18,8 CM",NITRONPLAST,Em linha,R36-B08-A02-P01,113,11,0,102
10839,142,"FRASQUEIRA GRANDE P/MEDICAMENTOS -19,8X28X18,8 CM",NITRONPLAST,Em linha,R36-B08-A02-P02,206,0,0,206
9017,043,"FRASQUEIRA MINI ORGANIZADOR  15,7 X 19 X 10 CM",NITRONPLAST,Promocao,R36-B09-A02-P01,558,18,0,540
9497,120,"FRASQUEIRA MEDIA C/ BANDEJA  16,3 X 24,2 X 12,8 CM",NITRONPLAST,Em linha,R36-B07-A02-P01,189,10,0,179
16431,202,"FRASQUEIRA OVAL 2,7 X 1,8 X 1,8 CMS",NITRONPLAST,Em linha,R37-B05-A02-P02,79,1,0,78
33170,137,"FRASQUEIRA MEDICAMENTO - 16,3X24,2X12,8 CM ",NITRONPLAST,Em linha,R37-B06-A02-P02,219,13,0,206
13063,185,PORTA VASSOURAS C/ 4 ENCAIXES E GANCHOS,NITRONPLAST,Em linha,R36-B06-A01-P01,1004,10,0,994
8380,013,SUPORTE PARA BOTIJAO,NITRONPLAST,Em linha,R37-B02-A00-P01,3314,88,0,3226
8378,010/B,CJ DE CABIDES COM 3 PECAS,NITRONPLAST,Em linha,R37-B04-A00-P01,536,21,0,515
34166,053,"PRATELEIRA MULTIUSO 04 AND - 39,5X30X75 CM",NITRONPLAST,Em linha,R37-B02-A02-P02,93,0,0,93
57196,284/P,CESTO TRANSPORTA TUDO PRETO,NITRONPLAST,Lancamento,R36-B01-A00-P01,206,8,0,198
15094,172,PA DE LIXO C/ CABO,NITRONPLAST,Promocao,R37-B08-A01-P01,2021,105,0,1916
9905,125,"NITRONBOX ALTA 4,3 LTS - 17,8 X 29 X 14,6 CM",NITRONPLAST,Em linha,R36-B05-A01-P01,238,19,0,219
9903,109,"NITRONBOX BAIXA 6 LTS - 22 X 34,5 X 13 CM",NITRONPLAST,Em linha,R36-B03-A01-P01,302,20,0,282
9900,097,"NITRONBOX BAIXA 10 LTS - 29,3 X 41 X 13,6 CM",NITRONPLAST,Em linha,R36-B01-A00-P02,190,4,0,186
10168,130,LIXEIRA RETRATIL 04 LTS,NITRONPLAST,Promocao,R36-B08-A02-P03,532,18,0,514
11854,173,LIXEIRA FENIX 4 LTS,NITRONPLAST,Promocao,R37-B08-A00-P01,497,39,0,458
9902,100,LIXEIRA DE PEDAL 7 LTS,NITRONPLAST,Promocao,R38-B14-A00-P01,258,4,0,254
25973,150,LIXEIRA DE PEDAL 16 LTS,NITRONPLAST,Promocao,R38-B15-A00-P01,208,0,0,208
9499,128,"CESTO P/ PRENDEDOR ROUPAS 18,8X24X11 CMS",NITRONPLAST,Em linha,R36-B01-A01-P03,1323,14,0,1309
17421,177,"CESTINHO C/ ALÇA  19,3 X 28 X 13,5 CMS",NITRONPLAST,Em linha,R37-B04-A00-P02,532,0,0,532
8475,093,"CESTINHO VERSATIL 20X28,5X10,5 CMS",NITRONPLAST,Em linha,R36-B05-A00-P03,555,12,0,543
17422,187,ORGANIZA TUDO  TOP GRANDE - 27 X 36 X 6 CMS,NITRONPLAST,Em linha,R36-B07-A01-P01,261,1,0,260
9494,106,"ORGANIZA TUDO GRANDE - 19,5 X 30 X 4,8 CM",NITRONPLAST,Em linha,R36-B07-A01-P02,871,19,0,852
10834,138,"ORGANIZA TUDO MEDIO - 4,3 X 17,5 X 26,2 CM",NITRONPLAST,Em linha,R36-B07-A01-P03,630,12,0,618
8474,019,"ORGANIZA TUDO COM DIVISORIAS 11,8 X 20,5 X 4 CM",NITRONPLAST,Promocao,R36-B08-A01-P04,1704,8,0,1696
9367,011,"ORGANIZA TUDO MINI  9,5 X 13,5 X 3,2 CM",NITRONPLAST,Em linha,R36-B03-A01-P02,768,1,0,767
57197,213/AP,CAIXA PRÁTICA DOBRÁVEL 20 LT  AZUL / PRETA,NITRONPLAST,Lancamento,R37-B08-A00-P02,73,0,0,73
8394,095,CANTONEIRA DE BANHEIRO - 22X14X38 CM,NITRONPLAST,Em linha,R37-B02-A02-P01,1047,39,0,1008
9290,079,"PORTA SHAMPOO PRATELEIRA MADRID - 9,2X17X39,6 CM",NITRONPLAST,Em linha,R37-B01-A02-P02,2547,33,0,2514
10416,122,"PORTA ESCOVA C/ TAMPA - 8,9 X 11,5 X 20,2 CM",NITRONPLAST,Promocao,R37-B03-A02-P02,1028,27,0,1001
10612,140,"ESTOJO MULTIUSO - 21 X 7 X 3,5 CM",NITRONPLAST,Em linha,R36-B06-A01-P02,1062,21,0,1041
29416,033,JARRA C/ ESPREMEDOR 02 LTS,NITRONPLAST,Em linha,R37-B04-A02-P01,869,43,0,826
15090,032,JARRA C/ TAMPA 02 LTS,NITRONPLAST,Em linha,R37-B10-A02-P02,1815,50,0,1765
34167,064,JARRA C/ RESERVATORIO P/ GELO 02 LTS,NITRONPLAST,Em linha,R36-B08-A01-P03,159,3,0,156
20518,222,"JARRA FLIP TOP 1,3 LTS",NITRONPLAST,Promocao,R37-B03-A00-P02,1172,88,0,1084
12473,153,JARRA GRADUADA C/ TAMPA FLIP TOP 2 LTS,NITRONPLAST,Em linha,R37-B06-A00-P02,1892,140,0,1752
12472,182,JARRA FLIP TOP GRADUADA 4 LTS,NITRONPLAST,Em linha,R37-B05-A00-P02,336,12,0,324
46906,111,ESPREMEDOR PORTÁTIL FIT 510 ML,NITRONPLAST,Promocao,R36-B01-A02-P01,1248,73,0,1175
46904,207,JARRA MEDIDORA TOP MIX 850 ML,NITRONPLAST,Em linha,R36-B07-A02-P02,377,12,0,365
8385,023,RALADOR 4 FACES,NITRONPLAST,Em linha,R37-B03-A00-P01,1199,66,0,1133
30408,255,FORMA DE GELO FIRENZE C/ TAMPA,NITRONPLAST,Em linha,R36-B04-A01-P01,2941,486,0,2455
8389,051,"PORTA DETERGENTE/SABAO/ESPONJA - 28X10,2X6,5 CM",NITRONPLAST,Em linha,R36-B08-A00-P01,1833,67,0,1766
9020,113,PORTA SABAO TANQUINHO,NITRONPLAST,Em linha,R36-B01-A01-P01,454,0,0,454
45661,245,POTE ACOPLADO 500 ML C/ ROSCA FEIJÃO,NITRONPLAST,Em linha,R36-B10-A01-P01,216,16,0,200
45658,248,POTE ACOPLADO 500 ML C/ ROSCA TOMATINHO,NITRONPLAST,Em linha,R36-B09-A01-P02,351,13,0,338
45659,249,POTE ACOPLADO 500 ML C/ ROSCA TEMPEROS,NITRONPLAST,Em linha,R36-B09-A01-P03,372,0,0,372
45660,252,POTE ACOPLADO 500 ML C/ ROSCA QUEIJO RALADO,NITRONPLAST,Em linha,R36-B10-A01-P03,300,4,0,296
52653,278,POTE ACOPLADO 500 ML C/ ROSCA CEBOLA,NITRONPLAST,Em linha,R36-B10-A01-P02,252,6,0,246
52654,279,POTE ACOPLADO 500 ML C/ ROSCA ALHO,NITRONPLAST,Em linha,R36-B09-A01-P01,256,10,0,246
52658,237,"POTE C/ ROSCA ARROZ 5,8 L C/ MEDIDOR",NITRONPLAST,Em linha,R36-B02-A00-P01,310,14,0,296
48559,238/A,POTE ROSCA 2L AÇUCAR,NITRONPLAST,Em linha,R36-B02-A01-P01,1591,448,0,1143
48558,238/CA,POTE ROSCA 2L CAFÉ,NITRONPLAST,Em linha,R36-B06-A02-P03,1680,442,0,1238
30404,158,POTE FEIJAO C/ TRAVA RETANG 850 ML,NITRONPLAST,Em linha,R37-B04-A02-P02,1186,74,0,1112
25149,157,POTE TOMATINHO RETANGULAR C/ TRAVA 850 ML,NITRONPLAST,Em linha,R36-B08-A00-P02,1288,79,0,1209
57193,038/AR,"POTE REDONDO 2,9L ARROZ",NITRONPLAST,Lancamento,R36-B06-A01-P03,1943,471,0,1472
57195,038/F,"POTE REDONDO 2,9L FEIJÃO",NITRONPLAST,Lancamento,R37-B02-A01-P01,1782,471,0,1311
57192,038/A,"POTE REDONDO 2,9L AÇUCAR",NITRONPLAST,Lancamento,R36-B04-A01-P03,1941,477,0,1464
57194,038/CA,"POTE REDONDO 2,9L CAFÉ",NITRONPLAST,Lancamento,R36-B05-A01-P03,1043,45,0,998
28002,225,"PORTA TALHER SERVE E GUARDA - 20,5 X 24,7 X 5,9 CM",NITRONPLAST,Em linha,R36-B07-A00-P01,139,6,0,133
38067,224,SECA TALHER  ESCORRE & GUARDA,NITRONPLAST,Em linha,R37-B05-A01-P01,92,6,0,86
8382,016,MAX SECA TALHER OVAL,NITRONPLAST,Em linha,R36-B03-A00-P03,1187,32,0,1155
15093,144,PORTA TALHER C/ TAMPA 06 DIVISORIAS  29X34X5CMS,NITRONPLAST,Em linha,R37-B03-A01-P01,235,2,0,233
11855,117,"TÁBUA EXTRA GRANDE - 24,5 X 39 X 0,5 CM",NITRONPLAST,Em linha,R36-B08-A01-P01,283,13,0,270
8384,018/B,"TÁBUA MULT-USO GRANDE - 20,7X31,8X0,4 CM",NITRONPLAST,Em linha,R36-B08-A01-P02,830,16,0,814
30405,221/RA,SALEIRO PREMIER C/ TAMPA E ALCA,NITRONPLAST,Promocao,R37-B03-A02-P01,2187,477,0,1710
8396,090,SALEIRO RUBI 1 KG,NITRONPLAST,Em linha,R36-B10-A00-P01,2107,83,0,2024
9019,077,LAVA TUDO IDEAL,NITRONPLAST,Em linha,R36-B05-A01-P02,1026,51,0,975
46907,055,ESCORREDOR RED - ESCORRE E SERVE,NITRONPLAST,Promocao,R36-B04-A00-P02,432,45,0,387
21677,028,LAVA ARROZ ,NITRONPLAST,Em linha,R36-B01-A01-P02,2261,103,0,2158
10841,146,FORMA P/ COZINHAR OVOS NO MICROONDAS,NITRONPLAST,Em linha,R37-B07-A01-P02,435,32,0,403
25150,223/1,"PORTA FRIOS UNITARIO C/ TELA - 18 X 24,5 X 5 CM",NITRONPLAST,Em linha,R36-B03-A02-P02,439,0,0,439
12849,179,"PORTA FRIOS HERMETICO C/ PINCA - 26,2X17,5X5,3 CM",NITRONPLAST,Em linha,R37-B05-A01-P02,621,21,0,600
21679,027,"PORTA PAO - 34,5 X 14 X 13,5 CM",NITRONPLAST,Em linha,R36-B03-A02-P01,254,25,0,229
12848,191,POTE HERMETICO REDONDO C/ 2 DIV - 17 X 6 CM,NITRONPLAST,Promocao,R36-B09-A00-P02,333,16,0,317
16430,030/7,"POTE HERMETICO MONTEREY 3 DIV 21,2X21,2X5,5 CM",NITRONPLAST,Em linha,R36-B04-A00-P01,944,21,0,923
23547,050,"CONSERVADORA DE ALIMENTOS PREMIER 04 DIV- 1,25 LTS",NITRONPLAST,Em linha,R37-B07-A01-P02,1376,21,0,1355
12851,194,"LEGUMIX - PANELA P/ COZ MICROONDAS A VAPOR 2,6 LTS",NITRONPLAST,Em linha,R36-B09-A00-P01,121,0,0,121
25971,014,CACAROLA P/ MICRO-ONDAS 1500 ML - COLOR,NITRONPLAST,Em linha,R37-B04-A01-P02,513,20,0,493
37157,251,PANELA P/ MICRO-ONDAS MINI GOURMET 850 ML,NITRONPLAST,Em linha,R36-B03-A01-P03,511,20,0,491
17416,022/7,"POTE REDONDO C/ TRAVAS 2,3 LTS - 22,5X20,5X10 CM",NITRONPLAST,Em linha,R36-B02-A01-P02,282,13,0,269
17417,022/8,"POTE REDONDO C/ TRAVAS 1,1 LTS - 17,5X16,5X8 CM",NITRONPLAST,Em linha,R37-B07-A00-P01,331,16,0,315
17418,022/9,"POTE REDONDO C/ TRAVAS 450 ML - 13,5X12,5X6 CM",NITRONPLAST,Em linha,R37-B04-A01-P01,438,6,0,432
33171,105,MARMITA BOM APETITE C/ BANDEJA E VALVULA 800 ML,NITRONPLAST,Em linha,R37-B03-A01-P03,468,40,0,428
13066,139,"POTE HERMETICO 03 DIVISORIAS - 14 X 24 X 6,5 CM",NITRONPLAST,Em linha,R37-B06-A02-P01,1072,16,0,1056
8424,103,MARMITA C/ PORTA TALHERES 780 ML,NITRONPLAST,Em linha,R36-B03-A02-P03,1164,69,0,1095
21678,216,"POTE C/ TRAVAS ULTRA FORTE 04 LTS -20,5X30X10,5 CM",NITRONPLAST,Em linha,R37-B08-A01-P02,803,12,0,791
32470,025/4,CJ POTE RETANG C/ 03 PCS - 4600X2960X1500 ML,NITRONPLAST,Em linha,R36-B07-A00-P02,529,12,0,517
28006,244,"POTE RASO C/ VALVULA 3200 ML - 21 X 36 X 7,2 CM",NITRONPLAST,Em linha,R37-B06-A01-P02,333,2,0,331
28005,243,"POTE RASO C/ VALVULA 1900 ML - 18,5X30,5X5,9 CM",NITRONPLAST,Em linha,R37-B07-A00-P02,328,0,0,328
28004,242,POTE RASO C/ VALVULA 995 ML - 15 X 25 X 5 CM,NITRONPLAST,Em linha,R37-B03-A01-P02,417,0,0,417
25148,037/6,"POTE QUADRADO C/ TRAVAS 3,4 LTS - 23,5X25X10,8 CM",NITRONPLAST,Em linha,R37-B06-A01-P01,249,0,0,249
20504,037/7,"POTE QUADRADO C/ TRAVAS 1,8 LTS - 19,5X18,5X8,8 CM",NITRONPLAST,Em linha,R36-B03-A00-P01,655,10,0,645
20505,037/8,"POTE QUADRADO C/ TRAVAS 860 ML - 15,5X14,5X7,3 CM",NITRONPLAST,Em linha,R37-B07-A02-P01,871,12,0,859
17424,234,"POTE HERMETICO C/ TRAVAS RASO 2,25 LTS",NITRONPLAST,Em linha,R37-B05-A00-P01,542,6,0,536
15086,233,"POTE HERMETICO RASO C/TRAVA 1,1 LTS-14,5X21,6,5 CM",NITRONPLAST,Em linha,R36-B06-A00-P02,859,46,0,813
15085,232,"POTE HERMETICO RASO C/ TRAVA 500 ML-11X17X5,3 CM",NITRONPLAST,Em linha,R37-B06-A01-P03,752,32,0,720
17423,151,"POTE HERMETICO C/ TRAVAS 4,3 LTS  - 18X26X14 CM",NITRONPLAST,Em linha,R36-B06-A00-P01,226,12,0,214
12847,156,"POTE HERMETICO C/ TRAVAS 2,2 LTS - 14,5X12X21,7CMS",NITRONPLAST,Em linha,R36-B03-A00-P02,285,46,0,239
13064,154,"POTE HERMETICO C/TRAVAS 460 ML - 9,5X14X6,5 CM",NITRONPLAST,Em linha,R37-B02-A01-P02,565,20,0,545
50323,6301MO,CANECA 360 ML INFANTIL,JAGUAR,Promocao,R39-B01-A01-P01,959,78,480,881
50324,6300MO,CANECA C/ TAMPA 360 ML INFANTIL,JAGUAR,Em linha,R39-B01-A00-P01,855,58,0,797
51917,4193,CX DISPLAY 156 CANECAS 360 ML INFANTIL,JAGUAR,Em linha,R40-B17-A00-P01,20,0,0,20
50318,6297MO,COPO C/ TAMPA 360 ML INFANTIL,JAGUAR,Promocao,R39-B03-A01-P03,188,6,276,182
50319,6298MO,COPO 360 ML INFANTIL,JAGUAR,Em linha,R39-B01-A00-P02,659,54,528,605
50320,4167,TIGELA 550 ML INFANTIL,JAGUAR,Promocao,R39-B01-A00-P03,885,51,900,834
11980,1490,COPO INFANTIL 245 ML,JAGUAR,Em linha,R39-B04-A01-P02,1093,72,0,1021
29619,7703,PRATO INFANTL 680 ML - 22 CM,JAGUAR,Em linha,R39-B08-A01-P02,1121,54,0,1067
10133,7730,KIT INFANTIL C/ 03 PCS,JAGUAR,Promocao,R39-B06-A02-P01,766,28,0,738
26878,7740,KIT INFANTIL C/ 03 PCS,JAGUAR,Promocao,R39-B04-A02-P01,726,3,0,723
12922,1616,PORTA ESCOVA DE DENTES,JAGUAR,Em linha,R38-B04-A02-P02,4308,229,600,4079
9106,0605,SABONETEIRA,JAGUAR,Em linha,R38-B10-A02-P01,9411,525,1800,8886
40440,6503,PORTA ESCOVA DE DENTE MARMORIZADO,JAGUAR,Em linha,R39-B06-A02-P02,866,5,0,861
45252,6500,SABONETEIRA PARA PIA MARMORIZADA,JAGUAR,Em linha,R37-B10-A01-P04,605,30,0,575
26879,7738,BANHEIRA INFANTIL BARQUINHOS 23 LTS  AZUL,JAGUAR,Em linha,R38-B09-A00-P02,699,29,0,670
26880,7741,BANHEIRA INFANTIL BARQUINHOS 23 LTS  ROSA,JAGUAR,Em linha,R39-B10-A00-P01,696,27,0,669
26881,7742,BANHEIRA INFANTIL BARQUINHOS 23 LTS  CRISTAL,JAGUAR,Em linha,R39-B09-A00-P01,401,13,0,388
55034,6563MO,CX DISPLAY 252 PÇS ORG. RET 750 ML NUDE,JAGUAR,Em linha,R40-B18-A00-P01,23,2,15,21
48416,4185,CX DISPLAY 252 PÇS ORG. RET 750 ML INFANTIL FECHAD,JAGUAR,Em linha,R40-B15-A00-P01,52,1,0,51
46804,6038MO,ORGANIZ RET INFANTIL SORTIDO 220 ML,JAGUAR,Em linha,R39-B08-A00-P02,900,108,840,792
46805,6036MO,ORGANIZ RET INFANTIL SORTIDO 420 ML,JAGUAR,Em linha,R39-B07-A00-P01,629,76,1176,553
46806,6037MO,ORGANIZ RET INFANTIL SORTIDO 750 ML,JAGUAR,Em linha,R38-B02-A00-P02,1206,151,1488,1055
55137,6559MO,CJ ORGANIZ RET 8 PCS 220ML UNICORNIO,JAGUAR,Promocao,R38-B08-A02-P01,1569,2,0,1567
55139,6561MO,CJ ORGANIZ RET 8 PCS 220ML BALOONS,JAGUAR,Promocao,R37-B09-A00-P01,1328,2,0,1326
55138,6560MO,CJ ORGANIZ RET 8 PCS 220ML BLOCKS,JAGUAR,Promocao,R38-B07-A02-P02,1448,2,0,1446
55140,6562MO,CJ ORGANIZ RET 4 PCS 220/420/750/1270 ML BLOCKS,JAGUAR,Promocao,R38-B06-A02-P02,1426,14,0,1412
55135,6557MO,ORGANIZ RET 750ML BLOCKS,JAGUAR,Promocao,R38-B02-A01-P02,1228,36,0,1192
57067,6745,CJ ORGANIZ RET 3 PCS 220/420/1270 ML UNICORN,JAGUAR,Lancamento,R39-B02-A00-P01,371,22,0,349
55132,6554MO,ORGANIZ RET 750ML FLAMINGO,JAGUAR,Em linha,R38-B07-A01-P01,738,72,960,666
55134,6556MO,ORGANIZ RET 750ML SEREIA,JAGUAR,Em linha,R39-B07-A01-P01,1088,24,600,1064
55106,4188,CJ ORGANIZ RET 4 PCS 220/420/750/1270 ML ROSA,JAGUAR,Em linha,R38-B09-A02-P01,868,71,0,797
46809,4170,ORGANIZ RET ROSA 1200 ML,JAGUAR,Em linha,R39-B06-A01-P02,342,63,480,279
46808,4169,ORGANIZ RET ROSA 750 ML,JAGUAR,Em linha,R39-B03-A01-P02,1880,60,840,1820
50317,4165,COPO C/ TAMPA 550 ML FRASES,JAGUAR,Promocao,R40-B08-A01-P02,973,69,684,904
51909,6326,KIT 5 PÇS ORGANIZA 750 ML RET NUDE,JAGUAR,Em linha,R40-B09-A00-P02,2155,656,1800,1499
57058,6736,KIT 4 PÇS ORGANIZA 750 ML RET NUDE,JAGUAR,Lancamento,R38-B03-A01-P01,2254,51,0,2203
51908,6325,KIT 5 PÇS ORGANIZA 690 ML QUAD NUDE,JAGUAR,Em linha,R39-B10-A01-P02,2236,697,2700,1539
57059,6737,KIT 4 PÇS ORGANIZA 690 ML QUAD NUDE,JAGUAR,Lancamento,R38-B03-A00-P02,1852,77,96,1775
51910,6327,KIT 5 PÇS ORGANIZA 740 ML RED NUDE,JAGUAR,Em linha,R39-B10-A01-P01,1804,550,1800,1254
57060,6738,KIT 4 PÇS ORGANIZA 740 ML RED NUDE,JAGUAR,Lancamento,R38-B03-A01-P02,1893,37,0,1856
51912,6329,"KIT 3 PÇS ORGANIZA 1,2LT RET NUDE",JAGUAR,Em linha,R40-B10-A01-P01,1898,279,900,1619
57061,6739,"KIT 2 PÇS ORGANIZA 1,2LT RET NUDE",JAGUAR,Lancamento,R38-B04-A01-P02,1297,29,0,1268
51911,6328,"KIT 3 PÇS ORGANIZA 1,2L QUAD NUDE",JAGUAR,Em linha,R40-B10-A00-P02,1776,238,900,1538
57062,6740,"KIT 2 PÇS ORGANIZA 1,2L QUAD NUDE",JAGUAR,Lancamento,R38-B03-A00-P01,1357,34,0,1323
51913,6330,"KIT 3 PÇS ORGANIZA 1,2L RED NUDE",JAGUAR,Em linha,R40-B09-A00-P01,1719,130,0,1589
57063,6741,"KIT 2 PÇS ORGANIZA 1,2L RED NUDE",JAGUAR,Lancamento,R38-B04-A01-P01,1136,29,0,1107
57064,6742,"KIT 2 PÇS ORGANIZA 3,6L / 1,2 L RET NUDE",JAGUAR,Lancamento,R39-B02-A00-P02,2201,27,0,2174
57065,6743,"KIT 2 PÇS ORGANIZA 3L / 1,2 L QUAD NUDE",JAGUAR,Lancamento,R38-B04-A00-P02,1526,21,0,1505
57066,6744,"KIT 2 PÇS ORGANIZA 3L / 1,2 L RED NUDE",JAGUAR,Lancamento,R38-B04-A00-P01,1312,30,0,1282
51915,6333,"KIT 2 PÇS ORGANIZA 3,6L RET NUDE",JAGUAR,Em linha,R40-B09-A01-P02,2171,191,0,1980
51914,6332,KIT 2 PÇS ORGANIZA 3LT QUAD NUDE,JAGUAR,Em linha,R40-B09-A01-P02,1512,132,600,1380
51916,6331,KIT 2 PÇS ORGANIZA 3L RED NUDE,JAGUAR,Em linha,R40-B09-A01-P01,1249,110,0,1139
50315,6291,CX DISPLAY 252 PÇS ORG. RET 750 ML BON APPETIT,JAGUAR,Em linha,R40-B16-A00-P01,23,0,5,23
46811,6045MO,ORGANIZ RET FRASES 750 ML,JAGUAR,Em linha,R39-B01-A01-P02,2097,146,600,1951
46812,6046MO,ORGANIZ RET FRASES 1200 ML,JAGUAR,Em linha,R40-B07-A01-P02,869,72,120,797
11976,1487,PORTA FRIOS 1100 ML ,JAGUAR,Em linha,R39-B09-A01-P02,1565,59,480,1506
35668,4114,PORTA FRIOS DECOR,JAGUAR,Em linha,R39-B04-A01-P01,715,30,480,685
55105,4178,CJ ORGANIZ RET 4 PCS 220/420/750/1270 ML DEC 3,JAGUAR,Em linha,R38-B10-A01-P03,752,20,720,732
55108,4198,CJ ORGANIZ RED 4 PCS 210/370/740/1220 ML CORUJA,JAGUAR,Em linha,R39-B05-A01-P02,610,28,600,582
55110,4199,CJ ORGANIZ QUAD 4 PCS 230/390/690/1200 ML CORUJA,JAGUAR,Em linha,R39-B08-A02-P02,622,34,720,588
55116,4205,ORGANIZ ALTO RED 970ML CORUJA,JAGUAR,Em linha,R38-B07-A01-P03,426,96,840,330
55102,4196,ORGANIZ RET 750 ML CORUJA,JAGUAR,Em linha,R39-B08-A01-P01,1173,80,840,1093
55112,4201,ORGANIZ RED 740ML CORUJA,JAGUAR,Em linha,R39-B04-A01-P03,688,50,960,638
55117,4206,ORGANIZ QUAD 690ML CORUJA,JAGUAR,Em linha,R38-B09-A01-P01,672,104,840,568
55111,4200,CJ ORGANIZ QUAD 4 PCS 230/390/690/1200 ML FLORAL,JAGUAR,Em linha,R39-B10-A02-P03,1899,25,120,1874
55118,4207,ORGANIZ ALTO RED 970ML FLORAL,JAGUAR,Em linha,R39-B09-A01-P01,882,72,0,810
55104,4177,CJ ORGANIZ RET 4 PCS 220/420/750/1270 ML DEC 2,JAGUAR,Em linha,R38-B02-A02-P02,797,38,600,759
55113,4202,CJ ORGANIZ RED 4 PCS 210/370/740/1200 ML FLORAL,JAGUAR,Em linha,R39-B07-A01-P02,1931,22,0,1909
55103,4197,ORGANIZ RET 750 ML FLORAL,JAGUAR,Em linha,R40-B07-A01-P03,1786,74,600,1712
55115,4204,ORGANIZ RED740ML FLORAL,JAGUAR,Em linha,R40-B07-A01-P01,529,15,960,514
55114,4203,ORGANIZ QUAD 690ML FLORAL,JAGUAR,Em linha,R38-B07-A01-P02,372,62,960,310
55099,3097,CJ ORGANIZ RET 3 PCS 420/750/1270 ML,JAGUAR,Promocao,R39-B10-A02-P02,988,25,0,963
55100,3098,CJ ORGANIZ RET 4 PCS 220/420/750/1270 ML,JAGUAR,Promocao,R38-B08-A01-P01,461,21,300,440
55097,3091,CJ ORGANIZ RET 5 PCS 220 ML,JAGUAR,Promocao,R38-B09-A01-P02,2069,208,0,1861
55098,3093,CJ ORGANIZ RET 2 PCS 750 ML,JAGUAR,Promocao,R39-B02-A01-P02,953,42,0,911
55095,3055,"ORGANIZ RETANGULAR 3,6L",JAGUAR,Promocao,R37-B10-A01-P01,889,50,0,839
55121,3137,CJ ORGANIZ QUAD 3 PCS 390/690/1200 ML,JAGUAR,Promocao,R38-B09-A02-P02,853,14,0,839
55125,3141,CJ ORGANIZ QUAD 4 PCS 230/390/690/1200 ML,JAGUAR,Promocao,R39-B02-A01-P01,649,15,0,634
55122,3138,CJ ORGANIZ QUAD 5 PCS 230 ML,JAGUAR,Promocao,R39-B01-A01-P03,806,166,120,640
55124,3140,CJ ORGANIZ QUAD 2 PCS 690 ML,JAGUAR,Em linha,R39-B09-A02-P01,552,9,180,543
55119,3135,ORGANIZ QUAD 3L,JAGUAR,Promocao,R38-B01-A01-P03,574,42,144,532
55120,3136,CJ ORGANIZ RED 3 PCS 370/740/1220 ML,JAGUAR,Promocao,R38-B08-A01-P02,1225,3,0,1222
55123,3139,CJ ORGANIZ RED 4 PCS 210/370/740/1220 ML,JAGUAR,Promocao,R38-B10-A02-P02,645,0,0,645
55126,3142,CJ ORGANIZ RED 5 PCS 210 ML,JAGUAR,Em linha,R39-B05-A01-P03,1035,163,0,872
55128,3144,CJ ORGANIZ RED 2 PCS 740 ML,JAGUAR,Em linha,R37-B10-A01-P02,915,9,0,906
55127,3143,ORGANIZ RED 3L,JAGUAR,Promocao,R39-B03-A01-P01,264,16,156,248
55101,3099,CX DISPLAY 252 PÇS ORG. RET 750 ML TRANS,JAGUAR,Em linha,R40-B13-A00-P01,31,1,15,30
45263,2826MO,KIT MULTIUSO RET 10 PCS(8 PCS 220 ML+2 PCS 750 ML),JAGUAR,Em linha,R39-B09-A02-P02,4697,0,0,4697
55096,3061,CJ MULTIUSO 07 PCS RETANGULARES,JAGUAR,Promocao,R37-B09-A00-P02,492,2,0,490
55131,6553MO,CJ ORGANIZ RET 12 PCS 220ML,JAGUAR,Em linha,R39-B08-A02-P01,2698,8,0,2690
55107,3133,CJ ORGANIZ 06 PCS RET 750 ML - L6P5,JAGUAR,Em linha,R39-B05-A02-P02,872,10,900,862
46814,3060,ORGANIZ RET VERSATIL 3L,JAGUAR,Em linha,R39-B06-A01-P01,196,0,0,196
46813,3059,ORGANIZ RET VERSATIL 5L,JAGUAR,Em linha,R38-B01-A01-P02,1613,3,0,1610
55948,3117,"CJ 5 PCS MANTIM. C/ ROSCA (0,5/1,8/3,0/4,5/7,8L)",JAGUAR,Em linha,R39-B08-A00-P01,759,41,144,718
55947,3116,"CJ 3 PCS MANTIM. C/ ROSCA (0,5/1,8/3 L)",JAGUAR,Em linha,R39-B06-A00-P01,328,26,24,302
55942,3118,"POTE MANTIMENTO COM ROSCA 0,5 L",JAGUAR,Em linha,R39-B08-A01-P04,123,43,960,80
55943,3119,"POTE MANTIMENTO COM ROSCA 1,8 L",JAGUAR,Em linha,R38-B02-A01-P01,410,13,240,397
55944,3113,POTE MANTIMENTO COM ROSCA 3 L,JAGUAR,Promocao,R39-B08-A01-P03,320,13,360,307
55945,3114,"POTE MANTIMENTO COM ROSCA 4,5 L",JAGUAR,Em linha,R38-B10-A01-P02,419,10,120,409
55946,3115,"POTE MANTIMENTO COM ROSCA 7,8 L",JAGUAR,Em linha,R38-B02-A02-P01,1147,24,0,1123
33067,1701,"CJ 5 PCS MANTIM. RED (0,6/0,97/1,6/3,2/5,1)",JAGUAR,Em linha,R39-B02-A02-P01,1032,29,240,1003
13201,0717,"CJ 5 PCS MANTIM. QUADR (1,1/1,75/3,45/5,6/8L)",JAGUAR,Promocao,R38-B01-A02-P01,256,16,0,240
55109,3134,CJ ORGANIZ ALTO QUAD 6 PCS,JAGUAR,Em linha,R38-B04-A02-P01,290,2,0,288
10135,0628,PORTA FILTRO E CAFE,JAGUAR,Em linha,R38-B07-A02-P01,892,19,0,873
8352,0615,FORMA PARA GELO FLEXIVEL,JAGUAR,Promocao,R38-B10-A01-P01,5263,156,0,5107
29618,1407,KIT SALEIRO / PALITEIRO DE MESA,JAGUAR,Em linha,R40-B09-A02-P03,439,1,900,438
55129,3145,ORGANIZ ALTO QUAD.  8L,JAGUAR,Em linha,R38-B01-A02-P02,368,0,0,368
55130,3200,"ORGANIZ ALTO QUAD.  5,6L",JAGUAR,Em linha,R39-B05-A00-P02,322,6,0,316
39246,0788,"PORTA TALHERES COM TAMPA - 31 X 21 X 4,5 CM",JAGUAR,Em linha,R38-B02-A00-P01,923,47,0,876
4366,0016,ESCORREDOR P/ LOUCAS,JAGUAR,Em linha,R40-B10-A02-P01,1053,53,0,1000
55035,3120,ESCORREDOR P/ LOUÇAS COMPACTO,JAGUAR,Em linha,R39-B01-A02-P01,155,12,0,143
46815,1562,BANDEJA MULTIUSO 44 X 32 CM,JAGUAR,Em linha,R38-B01-A01-P01,285,40,0,245
35670,0027,"QUEIJEIRA  21,5 X 7 CMS",JAGUAR,Promocao,R38-B06-A02-P01,1102,29,0,1073
35669,0025,BOLEIRA 27 X 11 CMS,JAGUAR,Em linha,R39-B01-A02-P02,1926,499,900,1427
12919,1615,COADOR 11 CM,JAGUAR,Promocao,R40-B09-A02-P01,656,0,0,656
26005,2016,COADOR 16 CM,JAGUAR,Em linha,R40-B10-A02-P02,511,0,0,511
26006,2017,COADOR 19 CM,JAGUAR,Em linha,R40-B09-A02-P02,357,0,0,357
4365,0013,ESCORREDOR P/MASSAS,JAGUAR,Em linha,R39-B05-A01-P01,160,6,60,154
11979,1486,"JARRA C/ ESPREMEDOR 1,2 LTS",JAGUAR,Em linha,R39-B03-A02-P02,2594,193,600,2401
4208,0078,JARRA QUADRADA 02 LTS,JAGUAR,Em linha,R39-B04-A00-P01,3180,178,360,3002
5213,0088,CJ JARRA C/04 COPOS,JAGUAR,Em linha,R39-B03-A02-P01,256,18,240,238
7571,0008,KIT 4 COPOS 350 ML ,JAGUAR,Em linha,R39-B10-A00-P01,1815,78,0,1737
10635,0736,GARRAFA P/ AGUA 02 LTS   ,JAGUAR,Em linha,R38-B03-A02-P02,1754,104,1200,1650
33040,3003,"RECIPIENTE P/ AGUA DEC 3,2 LTS",JAGUAR,Em linha,R38-B05-A02-P02,535,11,300,524
12465,1565,"JARRA REDONDA 3,7 LTS",JAGUAR,Em linha,R39-B10-A02-P01,3825,128,1500,3697
7212,0002,JARRA QUADRADA 3.5 LTS,JAGUAR,Em linha,R38-B05-A02-P01,250,12,120,238
15079,1720,PORTA SABAO EM PO 1 KG,JAGUAR,Promocao,R37-B10-A00-P01,202,19,0,183
12468,0031,"BALDE 7,5 LTS",JAGUAR,Em linha,R38-B02-A00-P03,507,0,0,507
12466,0029,"BALDE 13,5 LTS",JAGUAR,Promocao,R40-B07-A00-P03,265,0,60,265
12467,0030,BALDE 18 LTS,JAGUAR,Promocao,R40-B07-A00-P02,249,18,0,231
4202,0057,LIXEIRA P/PIA 5.5 LTS - BRANCA,JAGUAR,Em linha,R40-B08-A01-P01,312,9,0,303
7578,0518,"BALDE 7,5 LTS     TRANSPARENTE",JAGUAR,Em linha,R40-B08-A00-P02,1333,50,0,1283
7576,0516,BALDE 13.5 LITROS TRANSPARENTE,JAGUAR,Promocao,R40-B08-A00-P03,364,8,0,356
7577,0517,BALDE 18 LITROS TRANSPARENTE,JAGUAR,Em linha,R40-B08-A00-P04,203,6,0,197
24366,2045,BALDE MAX 12 L TRANSPARENTE,JAGUAR,Em linha,R38-B09-A00-P01,732,36,480,696
24369,2046,BALDE MAX 16 L TRANSPARENTE,JAGUAR,Em linha,R38-B01-A00-P02,272,8,0,264
10136,0729,BALDE C/ TAMPA 20 LTS,JAGUAR,Em linha,R40-B08-A00-P01,97,0,0,97
7579,0523,BACIA 1.5 LITROS TRANSPARENTE,JAGUAR,Em linha,R38-B08-A00-P01,1339,86,600,1253
7580,0524,BACIA 3.3 LITROS TRANSPARENTE  ,JAGUAR,Promocao,R38-B08-A00-P02,1476,73,360,1403
7581,0526,BACIA 6.7 LITROS TRANSPARENTE,JAGUAR,Promocao,R38-B08-A00-P03,1795,52,0,1743
7582,0528,BACIA 15 LITROS TRANSPARENTE,JAGUAR,Em linha,R38-B07-A00-P02,460,29,120,431
4209,0595,BACIA GIGANTE 30 LTS TRANSP,JAGUAR,Em linha,R38-B07-A00-P01,439,14,60,425
56422,3126,"CAIXA JUTA 1,8L C/ TPA COR SORT",JAGUAR,Promocao,R37-B09-A01-P02,1081,441,900,640
56423,3127,CAIXA JUTA 05L C/ TPA COR SORT,JAGUAR,Em linha,R37-B09-A01-P02,408,4,132,404
56424,3128,CAIXA JUTA 15L C/ TPA COR SORT,JAGUAR,Em linha,R37-B09-A01-P01,377,4,0,373
56425,3131,CESTA JUTA 02L COR SORT,JAGUAR,Em linha,R38-B08-A02-P02,1630,432,900,1198
56426,3130,"CESTA JUTA 5,2L COR SORT",JAGUAR,Em linha,R38-B03-A02-P01,1389,432,1086,957
56427,3129,"CESTA JUTA 11,5L COR SORT",JAGUAR,Em linha,R39-B07-A02-P01,533,24,0,509
26874,2013T,ORGANIZADOR 58 LITROS - 65 X 46 X 31 CMS,JAGUAR,Promocao,R39-B04-A02-P02,66,1,30,65
26873,2012T,ORGANIZADOR 78 LITROS - 65 X 46 X 41 CMS,JAGUAR,Promocao,R39-B07-A02-P02,57,3,32,54
20281,1786,LIXEIRA COM PEDAL 07 LTS - BRANCA,JAGUAR,Em linha,R39-B07-A00-P02,571,0,0,571
20282,1789,LIXEIRA COM PEDAL 20 LTS - BRANCA,JAGUAR,Em linha,R39-B05-A02-P01,724,2,0,722
20283,1793,LIXEIRA COM PEDAL 40 LTS - BRANCA,JAGUAR,Em linha,R38-B01-A00-P01,145,6,40,139
7574,0509,LIXEIRA COM PEDAL 15 LTS - BRANCA,JAGUAR,Em linha,R37-B10-A00-P02,802,0,0,802
7316,0018,LIXEIRA BASCULANTE P/ CANTO 12 LTS - BRANCA,JAGUAR,Promocao,R39-B04-A00-P02,269,16,0,253
10402,0062,LIXEIRA BASCULANTE P/CANTO 7.5 LTS - BRANCA,JAGUAR,Em linha,R39-B03-A00-P01,190,6,0,184
4367,0020,LIXEIRA BASCULANTE P/PIA 5.5 LTS - BRANCA,JAGUAR,Em linha,R39-B05-A00-P01,547,2,840,545
20287,0090,CESTO FECHADO 30 LTS - BRANCO,JAGUAR,Em linha,R38-B06-A00-P01,67,6,30,61
11983,0069,CESTO FECHADO 60 LTS - BRANCO,JAGUAR,Em linha,R40-B22-A00-P02,87,6,30,81
11982,0737,CESTO FECHADO 93 LTS - BRANCO,JAGUAR,Em linha,R40-B20-A00-P01,164,10,0,154
45251,5017,CESTO FECHADO C/ TAMPA 10 LTS,JAGUAR,Em linha,R38-B10-A00-P01,1096,447,900,649
5215,5090,CESTO FECHADO C/ TAMPA 30 LITROS,JAGUAR,Em linha,R38-B06-A00-P02,254,2,0,252
5214,5069,CESTO FECHADO C/ TAMPA 60LTS,JAGUAR,Em linha,R40-B21-A00-P01,557,8,0,549
10234,5737,CESTO FECHADO C/ TAMPA 93 LTS,JAGUAR,Em linha,R40-B19-A00-P01,239,2,0,237
7211,0001,CESTO TELADO 30 LITROS - BRANCO,JAGUAR,Promocao,R38-B05-A00-P03,179,6,0,173
1857,0050,CESTO TELADO C/TAMPA 60LTS - BRANCO,JAGUAR,Promocao,R38-B06-A00-P03,314,0,0,314
11849,1442,CESTO TELADO RETANGULAR C/ TAMPA 30 LTS - BRANCO,JAGUAR,Promocao,R38-B05-A00-P02,227,10,0,217
20286,1794,CESTO TELADO RETANGULAR C/ TAMPA 60 LTS - BRANCO,JAGUAR,Em linha,R38-B05-A00-P01,191,10,0,181
54856,379,CAIXA TOPA TUDO 4L 34 X 23 X 7 CM PRETO,SANTANA,Promocao,R41-B07-A02-P02,803,78,0,725
54857,378,"CAIXA TOPA TUDO 8L 44 X 28 X 7,9 CM PRETO",SANTANA,Em linha,R41-B10-A02-P02,575,48,0,527
54858,173,"CAIXA TOPA TUDO 11,5L - 51,5 X 30 X 9,5 CM PRETO",SANTANA,Em linha,R41-B10-A02-P01,162,12,60,150
52538,279,CAIXA TOPA TUDO 4L 34 X 23 X 7 CM,SANTANA,Em linha,R41-B10-A01-P01,1618,110,600,1508
52537,278,"CAIXA TOPA TUDO 8L 44 X 28 X 7,9 CM",SANTANA,Promocao,R41-B10-A01-P02,2729,920,360,1809
4038,73,"CAIXA TOPA TUDO 11,5L - 51,5 X 30 X 9,5 CM",SANTANA,Em linha,R41-B01-A01-P01,724,48,0,676
52539,2911,CAIXA TOPA TUDO 4L C/ TAMPA 34 X 23 X 7 CM,SANTANA,Em linha,R40-B06-A00-P03,1020,437,240,583
12162,912,CAIXA TOPA TUDO 8L C/ TAMPA- 43 X 28 X 8 CM,SANTANA,Em linha,R40-B05-A00-P02,622,23,0,599
11041,915,"CAIXA TOPA TUDO 11,5L C/ TAMPA - 52 X 31 X 11 CM",SANTANA,Em linha,R42-B10-A02-P01,518,17,0,501
13994,914,"CAIXA TOPA TUDO 5,65L C/ TAMPA - 34 X 24,5 X 11 CM",SANTANA,Em linha,R41-B08-A02-P01,1646,864,240,782
16371,913,"CAIXA TOPA TUDO 12L C/ TAMPA - 44 X 29 X 14,5 CM",SANTANA,Em linha,R42-B10-A02-P03,569,0,0,569
17653,916,"CAIXA TOPA TUDO 17L C/ TAMPA - 52 X 31 X 16,5 CM",SANTANA,Em linha,R41-B09-A00-P02,461,8,0,453
17652,71,"CAIXA TOPA TUDO 17L - 51,5 X 30 X 15 CM",SANTANA,Em linha,R42-B10-A02-P02,64,4,300,60
52525,3011,CAIXA ORGANIZADORA DU CHEFF 11 LTS C/ TPA TRANSP,SANTANA,Em linha,R41-B06-A01-P02,360,3,0,357
52526,3037,"CAIXA ORGANIZADORA DU CHEFF 3,7 LTS C/ TPA TRANSP",SANTANA,Em linha,R41-B05-A01-P02,384,10,0,374
52528,3020,CAIXA ORGANIZADORA DU CHEFF 2 LTS C/ TPA TRANSP,SANTANA,Em linha,R40-B06-A01-P02,263,0,0,263
12163,908,CAIXA TOPA TUDO 4 LTS,SANTANA,Em linha,R40-B04-A02-P02,449,17,0,432
10078,910,CAIXA TOPA TUDO 6 LTS,SANTANA,Em linha,R40-B05-A02-P02,1846,93,0,1753
8470,70,CONSERVADORA TOPA TUDO 6 LITROS,SANTANA,Em linha,R41-B07-A02-P01,592,19,0,573
48496,9910,CAIXA ORGANIZE 6 LITROS,SANTANA,Em linha,R40-B03-A02-P01,203,4,120,199
34177,970,CAIXA ORG C/ TAMPA 06 LTS,SANTANA,Em linha,R41-B05-A02-P03,213,3,0,210
42248,9905    ,CAIXA TOPA TUDO 5 LTS,SANTANA,Em linha,R41-B03-A02-P02,109,6,0,103
8695,920,CAIXA ORG TOPA TUDO 14 LTS,SANTANA,Em linha,R40-B01-A02-P01,720,35,90,685
11498,930,CAIXA ORG TOPA TUDO 20 LTS,SANTANA,Em linha,R40-B05-A02-P01,278,10,0,268
33153,936,CAIXA ORG C/ TAMPA 18 LTS,SANTANA,Em linha,R40-B06-A02-P02,264,13,0,251
33154,941,CAIXA ORG C/ TAMPA 31 LTS,SANTANA,Em linha,R40-B06-A02-P01,425,12,0,413
38117,455,"TIGELA 5,5 LTS C/ TAMPA",SANTANA,Promocao,R41-B02-A01-P01,1013,84,480,929
38114,1111,POTE QUAD GRADUADO 1100 ML - COLOR,SANTANA,Em linha,R41-B01-A02-P01,1335,18,0,1317
38115,1411,POTE RED GRADUADO 1100 ML - COLOR,SANTANA,Em linha,R40-B04-A01-P02,1152,26,0,1126
4052,840,POTE HERM.RETANG.RASO PEQ.AVULSO 515ML,SANTANA,Em linha,R41-B03-A00-P01,781,60,600,721
4053,850,POTE HERM.RETANG.RASO MD.AVULSO 1.125ML,SANTANA,Em linha,R41-B02-A00-P03,581,56,120,525
4054,860,POTE HERM.RETANG.RASO GR.AVULSO 2.470ML,SANTANA,Em linha,R41-B03-A00-P02,274,38,240,236
4055,870,POTE HERM.RETANG.FUNDO PEQ.AVULSO 865ML,SANTANA,Em linha,R41-B01-A00-P03,2005,192,720,1813
4056,880,POTE HERM.RETANG.FUNDO MD.AVULSO 1.900ML,SANTANA,Em linha,R41-B01-A00-P02,1403,84,180,1319
4057,890,POTE HERM.RETANG.FUNDO GR.AVULSO 4.170ML,SANTANA,Em linha,R41-B04-A00-P01,1257,23,0,1234
4049,810,POTE HERM.QUAD PEQUENO AVULSO 335ML,SANTANA,Em linha,R41-B04-A00-P02,1474,120,900,1354
4050,820,POTE HERM.QUAD MEDIO AVULSO 1.040ML,SANTANA,Promocao,R41-B02-A00-P01,1658,102,480,1556
4051,830,POTE HERM.QUAD GRANDE AVULSO 2.220ML,SANTANA,Em linha,R41-B01-A00-P01,1386,80,120,1306
10905,8001,POTE HERM.AVULSO PEQ 550 ML,SANTANA,Em linha,R41-B09-A01-P03,2257,300,420,1957
10906,8002,POTE HERM.AVULSO MEDIO 1 LT,SANTANA,Promocao,R41-B09-A01-P02,1595,119,600,1476
9910,8003,POTE HERM.AVULSO GDE 1950 ML,SANTANA,Em linha,R41-B09-A01-P01,1302,105,120,1197
21315,407,POTE RED GRADUADO 700 ML,SANTANA,Em linha,R41-B04-A01-P01,803,120,480,683
21316,411,POTE RED GRADUADO 1100 ML,SANTANA,Em linha,R40-B03-A01-P02,1379,36,0,1343
40447,5106,CJ C/ 05 POTES GRADUADO QD 600 ML,SANTANA,Em linha,R40-B02-A00-P01,1145,166,720,979
34174,5107,CJ C/ 05 POTES GRADUADO QD 700 ML,SANTANA,Em linha,R41-B10-A00-P01,987,106,900,881
12766,119,POTE QUAD GRADUADO 1900 ML,SANTANA,Em linha,R41-B02-A00-P02,831,72,480,759
12161,111,POTE QUAD GRADUADO 1100 ML,SANTANA,Em linha,R40-B06-A00-P01,2126,48,0,2078
40445,109,POTE QUAD GRADUADO 900 ML,SANTANA,Em linha,R40-B07-A02-P02,943,111,1200,832
40446,106,POTE QUAD GRADUADO 600 ML,SANTANA,Em linha,R41-B02-A01-P02,664,84,900,580
12160,107,POTE QUAD GRADUADO 700 ML,SANTANA,Em linha,R41-B07-A01-P02,1471,60,0,1411
13991,217,POTE QUAD GRADUADO 1700 ML,SANTANA,Em linha,R40-B06-A00-P02,643,6,0,637
13992,225,POTE QUAD GRADUADO 2500 ML,SANTANA,Em linha,R41-B03-A00-P03,782,27,120,755
34175,2225,CJ C/ 02 POTES GRADUADO QD 2500 ML,SANTANA,Em linha,R40-B03-A02-P02,817,47,600,770
28557,2703,CJ C/ 02 POTES RETANGULAR 300 ML,SANTANA,Em linha,R41-B08-A01-P02,826,127,600,699
28559,508,POTE RET GRADUADO 800 ML,SANTANA,Em linha,R41-B08-A01-P03,1683,120,0,1563
31455,720,POTE RET GRADUADO 2000 ML,SANTANA,Em linha,R41-B03-A01-P02,293,45,300,248
34176,5706,CJ C/ 05 POTES GRADUADO RET 600 ML,SANTANA,Em linha,R40-B01-A01-P02,836,73,300,763
28560,515,POTE RET GRADUADO 1500 ML,SANTANA,Promocao,R41-B08-A01-P01,1047,52,900,995
31456,735,POTE RET GRADUADO 3500 ML,SANTANA,Promocao,R41-B05-A02-P02,797,56,0,741
25261,780,ESCORREDOR DE PRATOS MASTER 445X360X90 MM,SANTANA,Em linha,R40-B03-A00-P01,1761,507,360,1254
4042,770,ESCORREDOR DE PRATOS 440X335X50MM,SANTANA,Em linha,R42-B13-A00-P01,3692,182,1800,3510
8471,77S,BANDEJA SERV BEM  48 X 33 CM ,SANTANA,Em linha,R41-B04-A01-P03,965,10,0,955
33155,790,ESCORREDOR DE TALHERES C/ TAMPA,SANTANA,Em linha,R41-B06-A02-P02,298,6,0,292
8684,520,PORTA DETERGENTE,SANTANA,Em linha,R40-B01-A01-P01,1412,20,0,1392
10762,643,PILAO PARA TEMPERO / CAIPIRINHA,SANTANA,Em linha,R40-B02-A01-P03,2437,102,0,2335
38112,86,CESTA MULTIUSO 290X200X70 MM,SANTANA,Em linha,R40-B05-A00-P01,258,0,120,258
9151,56,FARINHEIRA TOPA TUDO 1 LITRO,SANTANA,Em linha,R40-B04-A00-P02,923,54,240,869
9154,750,ESCORREDOR DE MASSAS GRANDE,SANTANA,Em linha,R41-B02-A02-P02,853,26,120,827
9153,710,ESCORREDOR COM CABO,SANTANA,Em linha,R41-B08-A02-P02,1105,73,420,1032
4058,700,LAVA ARROZ PRATIKO(REDONDO) 1.200ML,SANTANA,Em linha,R40-B01-A01-P03,1023,54,0,969
4045,20,TAMPA PROTETORA DE ALIMENTOS P/MICROONDAS,SANTANA,Promocao,R40-B02-A01-P01,3390,105,0,3285
4046,21,FORMA DE BOLO E PUDIM P/MICROONDAS 1.650ML,SANTANA,Promocao,R40-B02-A01-P02,1125,27,0,1098
4047,22,PANELA DE ARROZ P/MICROONDAS 2.500ML,SANTANA,Em linha,R41-B03-A01-P01,1367,13,0,1354
4035,50,JARRA D'AGUA FILTRA GELO 1.750ML,SANTANA,Em linha,R40-B02-A02-P01,2724,149,900,2575
7149,616,JARRA FRESH 2 LITROS,SANTANA,Em linha,R40-B04-A01-P03,383,15,0,368
9191,2609,CJ C/ 02 COPOS FRESH 470 ML,SANTANA,Em linha,R40-B05-A01-P01,2884,71,0,2813
52529,611,COPO FRESH 470 ML C/ TAMPA,SANTANA,Em linha,R41-B06-A00-P01,335,0,0,335
42247,450    ,BOLEIRA C/ TAMPA - 35 X 13 CM,SANTANA,Em linha,R41-B04-A02-P02,420,12,0,408
54855,430,QUEIJEIRA COM TAMPA 17 X 8 CM,SANTANA,Em linha,R40-B08-A02-P02,201,4,0,197
56983,420,"MANTEIGUEIRA / QUEIJEIRA COM TAMPA - 18X12X6,5 CM",SANTANA,Lancamento,R40-B04-A00-P02,358,30,240,328
52535,674,AÇUCAREIRO / FARINHEIRA / MOLHEIRA 500 ML,SANTANA,Em linha,R41-B06-A00-P02,471,11,0,460
52536,664,PORTA MEL 500 ML,SANTANA,Em linha,R41-B06-A02-P01,280,3,0,277
56984,410,AÇUCAREIRO C/ COLHER 400 ML,SANTANA,Lancamento,R40-B01-A02-P02,1085,474,240,611
31453,54,PALITEIRO CLEAR,SANTANA,Em linha,R40-B06-A01-P01,8129,472,2400,7657
31454,55,SALEIRO CLEAR,SANTANA,Em linha,R40-B04-A01-P01,10288,593,2400,9695
34180,118,POTE P/ CAFE 1900 ML,SANTANA,Promocao,R41-B04-A02-P01,1002,66,480,936
34179,117,POTE P/ ACUCAR 1900 ML,SANTANA,Promocao,R41-B05-A02-P01,969,54,300,915
54851,3810,CJ C/ 03 POTES 335 ML,SANTANA,Em linha,R41-B09-A02-P01,451,14,0,437
54854,8511,KIT LANCHE - COPO 470 ML + SANDUICHEIRA 680 ML,SANTANA,Em linha,R40-B08-A02-P01,641,0,0,641
9500,601,CANECA AVULSA 330 ML,SANTANA,Em linha,R40-B06-A01-P03,4389,124,0,4265
8473,607,PRATO FUNDO COM BORDA 23 CM,SANTANA,Em linha,R40-B05-A01-P02,1120,222,1800,898
9909,605,KIT INFANTIL C/ 03 PÇS    ,SANTANA,Promocao,R41-B01-A02-P02,2606,140,0,2466
11496,532,CJ C/ 02 SABONETEIRA SANTANA,SANTANA,Em linha,R41-B02-A02-P01,2506,542,900,1964
52533,540,CESTO TELADO 40 L NEON,SANTANA,Em linha,R41-B05-A00-P02,95,0,0,95
52532,115,"BACIA 14,8 L NEON",SANTANA,Em linha,R41-B05-A01-P01,339,0,0,339
52531,448,"BALDE 13,8 L NEON",SANTANA,Em linha,R41-B05-A00-P01,244,0,0,244
52530,447,BALDE 8 L NEON,SANTANA,Em linha,R41-B05-A00-P03,312,3,0,309
48497,553,CABIDE ADULTO C/ 03 PCS - BRANCO,SANTANA,Em linha,R40-B04-A02-P01,1026,30,0,996
52534,255,CABIDE ADULTO C/ 5 SMART,SANTANA,Em linha,R41-B05-A01-P03,224,4,0,220
38113,503,CESTA P/ PRENDEDOR DE ROUPAS 220X178X105 MM,SANTANA,Em linha,R40-B04-A00-P01,3110,216,1800,2894
54852,104,"CJ C/ 10 VASOS - 10,5 X 7,5 CM",SANTANA,Em linha,R41-B10-A02-P02,444,22,400,422
16373,34,BACIA TOPA TUDO 8 LTS,SANTANA,Em linha,R41-B01-A01-P02,562,24,0,538
16374,36,BACIA TOPA TUDO 10 LTS,SANTANA,Em linha,R40-B02-A00-P02,436,18,0,418
16375,38,BACIA TOPA TUDO 12 LTS,SANTANA,Promocao,R40-B02-A00-P03,642,17,0,625
21313,315,LIXEIRA BASCULANTE C/ TAMPA 05 LTS,SANTANA,Em linha,R41-B03-A02-P01,914,456,120,458
28562,335,LIXEIRA C/PEDAL 35 LTS - C/FIXADOR P/ SACO LIXO,SANTANA,Em linha,R40-B07-A02-P01,79,0,0,79
51083,353,LIXEIRA C/PEDAL 14 LTS PRETA,SANTANA,Em linha,R41-B06-A01-P01,640,40,300,600
6293,44,LIXEIRA C/PEDAL 14LTS BRANCA,SANTANA,Em linha,R41-B09-A00-P01,525,7,0,518
7144,49,LIXEIRA C/TAMPA BASCULANTE 14 LTS,SANTANA,Em linha,R41-B10-A00-P02,133,0,0,133
4048,45,CESTO TELADO 30LTS.C/TAMPA,SANTANA,Em linha,R41-B07-A00-P02,410,14,60,396
10765,507,CESTO TELADO QUADRADO 23X23X26 CM,SANTANA,Em linha,R41-B08-A00-P02,453,48,60,405
8469,46,CESTO TELADO 8 LITROS,SANTANA,Em linha,R41-B08-A00-P01,3499,177,0,3322
48499,2306,LIXEIRA MARBLE 06 LTS,SANTANA,Em linha,R40-B05-A02-P03,638,1,0,637
29291,306,LIXEIRA MULTIUSO 06 LTS,SANTANA,Em linha,R40-B03-A01-P01,248,24,120,224
8468,41,CESTO FECHADO C/ TAMPA 30 LITROS,SANTANA,Em linha,R41-B08-A00-P03,1307,486,180,821
11613,4002,BANQUETA ADULTA PRETA (SUPORTA ATÉ 110 KG),SANTANA,Em linha,R43-B13-A00-P01,1610,12,120,1598
48498,4003,BANQUETA ADULTA PRATA (SUPORTA ATÉ 110 KG),SANTANA,Em linha,R42-B14-A00-P02,286,0,0,286
7612,4001,BANQUETA ADULTA (SUPORTA ATÉ 110 KG),SANTANA,Em linha,R42-B14-A00-P01,422,12,0,410
11042,349,CESTO FECHADO C/ TAMPA PRETA 51 LTS REC,SANTANA,Em linha,R41-B07-A00-P03,1064,34,0,1030
11043,359,LIXEIRA BASCULANTE C/ TAMPA PRETA 60 LTS REC,SANTANA,Em linha,R40-B01-A00-P01,310,12,0,298
10220,360,LIXEIRA BASCULANTE C/ TAMPA COLETA SELETIVA 60 LTS,SANTANA,Em linha,R41-B07-A00-P01,278,6,0,272
48417,SR1011/61,CJ BULE 700 ML + SUP P/ FILTRO DE CAFÉ 102,SANREMO,Em linha,R43-B07-A02-P01,205,4,0,201
52448,SR1011/63,CJ BULE 700 ML + POTE 480 ML AMARELO,SANREMO,Em linha,R43-B06-A02-P02,202,1,0,201
52447,SR1011/62,CJ BULE 700 ML + SUP P/ FILTRO DE CAFÉ 102 VERM,SANREMO,Em linha,R43-B08-A02-P01,281,2,0,279
55965,SR1011/60,CJ BULE 700 ML + SUP P/ FILTRO DE CAFÉ 102 ROSA,SANREMO,Em linha,R42-B02-A02-P03,219,1,0,218
56530,SR1002/60,CJ GARRAFA TERMICA 1L + SUP FILTRO CAFÉ 103 COFFEE,SANREMO,Em linha,R43-B03-A01-P03,149,4,60,145
56531,SR1002/61,CJ GARRAFA TERMICA 1L + SUP FILTRO CAFÉ 103 LOVE,SANREMO,Em linha,R44-B08-A01-P02,225,7,0,218
54885,SR1041,BULE TERMICO ACOLHER 1L - 100% INOX,SANREMO,Em linha,R44-B10-A01-P01,156,6,0,150
54884,SR1040,BULE TERMICO ACOLHER 500ML - 100% INOX,SANREMO,Em linha,R44-B10-A01-P02,119,2,0,117
54886,SR1060,GARRAFA TERMICA EXPRESSAR 1L - 100% INOX,SANREMO,Em linha,R44-B10-A02-P03,38,0,0,38
54893,SR1050,GARRAFA TERMICA EXPRESSAR 1L - INOX,SANREMO,Em linha,R44-B10-A02-P02,43,0,90,43
54887,SR1061,"GARRAFA TERMICA EXPRESSAR 1,9L - 100% INOX",SANREMO,Em linha,R43-B09-A02-P02,59,0,0,59
54894,SR1051,"GARRAFA TERMICA EXPRESSAR 1,9L - INOX",SANREMO,Em linha,R44-B09-A02-P02,110,0,0,110
52867,SR1552/71,BOLSA TÉRMICA 4L,SANREMO,Em linha,R43-B07-A01-P02,38,4,0,34
52868,SR1556/71,BOLSA TÉRMICA 8L,SANREMO,Em linha,R43-B06-A01-P01,121,4,0,117
52869,SR1560/71,BOLSA TÉRMICA 12L,SANREMO,Em linha,R43-B08-A02-P03,64,2,0,62
56534,SR1102/1,SUPORTE P/ FILTRO DE CAFE TAM 102 - PRETO,SANREMO,Em linha,R44-B07-A01-P01,188,25,0,163
56535,SR1103/1,SUPORTE P/ FILTRO DE CAFE TAM 103 - PRETO,SANREMO,Em linha,R44-B07-A01-P02,549,30,0,519
56536,SR1103/3,SUPORTE P/ FILTRO DE CAFE TAM 103 - ROSA,SANREMO,Em linha,R44-B07-A01-P04,568,16,0,552
54890,SR1001/3,GARRAFA TERMICA ADORAR 250ML - ROSA,SANREMO,Em linha,R44-B10-A01-P04,139,0,0,139
54889,SR1001/1,GARRAFA TERMICA ADORAR 250ML - PRETA,SANREMO,Em linha,R44-B10-A01-P03,270,3,0,267
52440,SR1011/5,BULE TERMICO CUIDAR 700ML - VERMELHO,SANREMO,Em linha,R43-B06-A01-P02,150,2,0,148
45586,SR1011/3,BULE TERMICO CUIDAR 700ML - ROSA,SANREMO,Em linha,R43-B04-A01-P02,193,4,0,189
55966,SR1011/1,BULE TERMICO CUIDAR 700ML - PRETO,SANREMO,Em linha,R43-B05-A02-P03,152,2,0,150
55969,SR1002/4,GARRAFA TERMICA CELEBRAR  1L - BEGE,SANREMO,Em linha,R42-B01-A01-P01,121,0,0,121
45588,SR1002/3,GARRAFA TERMICA CELEBRAR  1L - ROSA,SANREMO,Em linha,R43-B04-A01-P03,234,0,0,234
52441,SR1002/1,GARRAFA TERMICA CELEBRAR  1L - PRETO,SANREMO,Em linha,R43-B06-A01-P03,116,0,0,116
54891,SR1014/1,GARRAFA TERMICA EXPRESSAR 500ML - PRETA,SANREMO,Em linha,R43-B09-A02-P03,110,2,0,108
54892,SR1014/3,GARRAFA TERMICA EXPRESSAR 500ML - ROSA,SANREMO,Em linha,R43-B09-A02-P01,250,0,0,250
46863,SR1015/1,GARRAFA TERMICA EXPRESSAR 1L - PRETO,SANREMO,Em linha,R44-B09-A02-P03,132,16,0,116
52442,SR1015/3,GARRAFA TERMICA EXPRESSAR 1L - VERMELHO,SANREMO,Em linha,R43-B10-A02-P03,150,6,0,144
56533,SR1016/50,"GARRAFA TERMICA EXPRESSAR 1,8L - COFFEE",SANREMO,Em linha,R43-B03-A01-P02,78,0,0,78
56532,SR1016/1,"GARRAFA TERMICA EXPRESSAR 1,8L - PRETO",SANREMO,Em linha,R44-B08-A01-P01,42,0,0,42
55968,SR1017/3,GARRAFA TERMICA GOSTAR 750ML - VERMELHO,SANREMO,Em linha,R42-B02-A01-P02,229,6,0,223
55967,SR1018/3 ,GARRAFA TERMICA AMAR  1L - VERMELHO,SANREMO,Em linha,R42-B02-A01-P03,271,19,0,252
45590,SR1017/4,GARRAFA TERMICA GOSTAR 750ML - BEGE,SANREMO,Em linha,R43-B04-A01-P01,100,13,60,87
45592,SR1018/4,GARRAFA TERMICA AMAR  1L - BEGE,SANREMO,Em linha,R44-B09-A02-P01,236,18,0,218
45589,SR1017/1,GARRAFA TERMICA GOSTAR 750ML - PRETO,SANREMO,Em linha,R44-B07-A02-P01,279,17,0,262
45591,SR1018/1,GARRAFA TERMICA AMAR  1L - PRETO,SANREMO,Em linha,R44-B08-A02-P01,176,35,120,141
15405,250,HYDRUS - BALDE 15 LTS,SANREMO,Em linha,R44-B08-A00-P03,414,10,0,404
52451,250/1,HYDRUS - BALDE 15 LTS TRANS AZUL,SANREMO,Em linha,R43-B08-A00-P01,164,7,0,157
21582,245,HYDRUS - BALDE 12 LTS,SANREMO,Em linha,R44-B08-A00-P02,942,8,0,934
52450,245/1,HYDRUS - BALDE 12 LTS TRANS AZUL,SANREMO,Em linha,R43-B08-A00-P03,401,13,0,388
15404,240,"HYDRUS - BALDE 8,5 LTS",SANREMO,Em linha,R44-B08-A00-P01,1004,8,0,996
52449,240/1,"HYDRUS - BALDE 8,5 LTS TRANS AZUL",SANREMO,Em linha,R43-B07-A00-P03,418,11,0,407
15401,230,"HYDRUS - BACIA 27,5 LTS",SANREMO,Em linha,R44-B10-A00-P02,125,6,0,119
52452,230/1,"HYDRUS - BACIA 27,5 LTS TRANS AZUL",SANREMO,Em linha,R43-B07-A00-P01,72,1,0,71
15400,220,HYDRUS - BACIA 14 LTS,SANREMO,Em linha,R44-B10-A00-P01,293,6,0,287
52453,220/1,HYDRUS - BACIA 14 LTS TRANS AZUL,SANREMO,Em linha,R43-B07-A00-P02,102,1,0,101
15399,210,"HYDRUS - BACIA 8,65 LTS",SANREMO,Em linha,R44-B09-A00-P03,267,0,0,267
15398,200,"HYDRUS - BACIA 5,2 LTS",SANREMO,Em linha,R44-B09-A00-P02,312,1,0,311
15407,267,"HYDRUS - PORTA SABAO EM PO C/ DOSADOR 2,35 LTS",SANREMO,Em linha,R43-B03-A02-P02,1492,477,0,1015
15402,237,HYDRUS - BALDE OVAL 14 LTS,SANREMO,Em linha,R44-B09-A00-P01,498,6,0,492
15406,265,"HYDRUS - ROUPEIRO TELADO 46,4 LTS",SANREMO,Em linha,R44-B07-A00-P02,82,2,0,80
32168,SR273/01,"CASABLANCA - LIXEIRA C/TPA BASCULANTE 4,3 LT - BCA",SANREMO,Em linha,R44-B08-A02-P03,276,2,0,274
32166,SR271/01,CASABLANCA - LIXEIRA C/TAMPA 06 LTS - BRANCA,SANREMO,Em linha,R43-B03-A00-P01,158,0,0,158
15429,825/4,BABY - BANHEIRA INFANTIL AZUL 26 LTS,SANREMO,Em linha,R43-B06-A00-P02,78,0,0,78
15430,825/40,BABY - BANHEIRA INFANTIL ROSA 26 LTS,SANREMO,Em linha,R43-B05-A00-P02,55,0,0,55
55981,SR907,ROLO ADESIVO PARA PELOS - 50 FOLHAS,SANREMO,Em linha,R43-B10-A01-P01,1393,495,1560,898
46862,PR9103-10,PRIMAFER CABIDE ADULTO C/10 PRETO,SANREMO,Em linha,R43-B05-A01-P02,1799,468,0,1331
45573,PR9105/6-2,PRIMAFER CABIDE PENDURA MAIS L6 P5 - BRANCO 40CM,SANREMO,Em linha,R44-B08-A02-P02,1589,480,0,1109
45574,PR9105/616,PRIMAFER CABIDE PENDURA MAIS L6 P5  - CINZA 40CM,SANREMO,Em linha,R43-B07-A02-P02,455,60,0,395
45576,PR9105/617,PRIMAFER CABIDE PENDURA MAIS L6 P5 - AZUL 40CM,SANREMO,Em linha,R43-B08-A02-P02,651,12,0,639
55978,SR281/20,CASABLANCA - LIXEIRA C/TAMPA BASCULANTE 10L CASTOR,SANREMO,Em linha,R44-B06-A02-P03,167,0,0,167
55980,SR279/20,CASABLANCA - LIXEIRA C/TAMPA BASCULANTE 19L CASTOR,SANREMO,Em linha,R42-B01-A02-P02,156,0,0,156
55979,SR283/20,CASABLANCA - LIXEIRA C/TAMPA BASCULANTE 30L CASTOR,SANREMO,Em linha,R42-B02-A02-P01,151,0,0,151
15415,298/01,CASABLANCA - LIXEIRA RETANG C/ PEDAL 36 LTS BRANCA,SANREMO,Em linha,R43-B02-A02-P01,99,2,0,97
15416,299/01,CASABLANCA - LIXEIRA RETANG C/ PEDAL 72 LTS BRANCA,SANREMO,Em linha,R44-B07-A02-P02,187,7,0,180
15123,285,CASABLANCA - LIXEIRA C/TAMPA BASCULANTE 105 LTS,SANREMO,Em linha,R43-B01-A00-P01,247,1,0,246
15122,284,CASABLANCA - LIXEIRA C/TAMPA BASCULANTE 59 LTS,SANREMO,Em linha,R43-B05-A00-P01,179,2,0,177
15121,283,CASABLANCA - LIXEIRA C/TAMPA BASCULANTE 30 LTS,SANREMO,Em linha,R43-B02-A02-P03,210,13,0,197
7658,281,CASABLANCA - LIXEIRA C/TAMPA BASCULANTE 10 LTS,SANREMO,Em linha,R43-B01-A02-P03,394,15,0,379
21583,278,"CASABLANCA - LIXEIRA DE PIA 6,5 LTS",SANREMO,Em linha,R43-B01-A02-P02,965,446,0,519
54898,SR1753/33,POTE COM TRAVAS ROSA 730ML,SANREMO,Em linha,R43-B02-A01-P02,341,0,0,341
54897,SR1752/33,POTE COM TRAVAS ROSA 820ML,SANREMO,Em linha,R43-B04-A02-P02,288,0,0,288
54896,SR1762/33,POTE COM TRAVAS ROSA 537ML,SANREMO,Em linha,R44-B10-A02-P01,231,16,0,215
54895,SR1763/33,POTE COM TRAVAS ROSA 330ML,SANREMO,Em linha,R43-B01-A01-P03,168,6,0,162
17437,490/2C,VAC FREEZER - CJ MANTIMENTOS 05 PCS,SANREMO,Em linha,R43-B04-A02-P01,39,4,0,35
17436,460/2C,VAC FREEZER - CJ POTE QUAD C/3PCS-580/1300/2500 ML,SANREMO,Em linha,R43-B07-A01-P02,164,2,0,162
17435,390/2C,VAC FREEZER - CJ POTE RET C/3PCS-1100/2340/4500 ML,SANREMO,Em linha,R43-B09-A01-P02,87,1,0,86
15421,790/2,VAC FREEZER - JARRA P/ SUCO 02 LTS,SANREMO,Em linha,R43-B03-A02-P01,1309,38,0,1271
46859,SR380/3C,"CJ 3 POTES VAC FREZER COLORS 1,1 L",SANREMO,Em linha,R43-B02-A01-P03,109,0,0,109
46858,SR455/3C,"CJ 3 POTES VAC FREZER COLORS 1,3 L",SANREMO,Em linha,R43-B08-A01-P02,106,0,0,106
34094,SR10/31,KIT POTES FACIL 72 PCS,SANREMO,Em linha,R43-B10-A00-P01,1368,0,0,1368
34095,SR10/28,KIT POTES FACIL / VAC 158 PCS,SANREMO,Promocao,R46-B13-A00-P02,6794,0,0,6794
56538,SR360/19,ANTICOVID- POTE RETANGULAR BAIXO 650 ML,SANREMO,Em linha,R44-B07-A01-P03,766,31,0,735
56539,SR380/19,"ANTICOVID- POTE RETANGULAR ALTO 1,1L",SANREMO,Em linha,R44-B08-A01-P03,795,58,0,737
56541,SR371/19,ANTICOVID- POTE PARA FRIOS 1L,SANREMO,Em linha,R43-B05-A01-P01,852,25,0,827
56537,SR450/19,ANTICOVID - POTE QUADRADO BAIXO 480 ML,SANREMO,Em linha,R43-B10-A01-P02,638,42,0,596
56540,SR455/19,"ANTICOVID- POTE QUADRADO BAIXO 1,3L",SANREMO,Em linha,R43-B03-A01-P01,944,57,0,887
52445,SR96/1,FIT - GARRAFA ESPORTIVA PLAST 500 ML - ROSA,SANREMO,Em linha,R43-B06-A02-P01,359,33,0,326
52446,SR96/2,FIT - GARRAFA ESPORTIVA PLAST 500 ML - AZUL,SANREMO,Em linha,R43-B02-A01-P01,420,33,0,387
42221,762/40,"GOLE GUT - GARRAFA REDONDA 1,6L",SANREMO,Em linha,R44-B06-A02-P01,350,29,0,321
17446,766/40,"GOLE GUT - GARRAFA RETANGULAR 1,75 LTS",SANREMO,Em linha,R42-B01-A02-P01,733,18,0,715
21581,767/40,"GOLE GUT - GARRAFA RETANGULAR 2,5 LTS",SANREMO,Em linha,R43-B01-A01-P01,170,17,120,153
42235,768/40,"GOLE GUT - GARRAFA RETANG 3,5L",SANREMO,Em linha,R43-B05-A02-P01,186,0,0,186
56542,SR501/555,PULVERIZADOR 580ML TRANSP,SANREMO,Promocao,R46-B14-A00-P02,4493,62,0,4431
57153,SR751/555,GOLE GUT - GARRAFA 250 ML,SANREMO,Lancamento,R46-B13-A00-P02,1540,20,0,1520
55972,SR10/38,KIT POTES 176 PÇS,SANREMO,Promocao,R46-B14-A00-P01,8272,0,0,8272
21580,340,"CASAR - ESCORREDOR PRATOS - 53,4 X 37,7 X 11,4 CM",SANREMO,Em linha,R43-B03-A00-P03,100,0,0,100
17445,343,CASAR - TRAVESSA P/ ALIMENTOS - 58X38X9 CMS,SANREMO,Em linha,R43-B09-A01-P01,152,0,0,152
17444,342,"CASAR - TRAVESSA P/ ALIMENTOS - 44X28,5X8,2 CMS",SANREMO,Em linha,R44-B09-A01-P02,820,432,0,388
21577,338,"CASAR - PORTA PAES 4360 ML -  35 X 13,8 X 13,7 CM",SANREMO,Em linha,R43-B09-A01-P03,993,56,0,937
15422,686,DIADIA - PORTA OVOS,SANREMO,Em linha,R43-B10-A02-P01,905,5,0,900
15166,590,RODO DE PIA 14 CMS,SANREMO,Em linha,R44-B09-A01-P03,2388,252,0,2136
15164,348,FORMA DE GELO P/ BEBIDAS,SANREMO,Promocao,R43-B08-A01-P01,3041,105,0,2936
15163,347,FORMA DE GELO PALITO,SANREMO,Promocao,R44-B09-A01-P01,808,122,0,686
33242,SR1260,FORMA DE GELO FLEXIVEL,SANREMO,Em linha,R43-B10-A01-P03,2021,728,4500,1293
15165,306,"FUNIL 12,8 CMS",SANREMO,Em linha,R43-B01-A01-P02,707,84,0,623
15147,328,FORMA P/ PICOLE,SANREMO,Em linha,R43-B02-A02-P02,790,20,0,770
55971,SR886/7,CJ L4P3 CESTA 746ML,SANREMO,Em linha,R42-B01-A01-P02,1522,0,0,1522
55970,SR884/7,"CJ L4P3 CESTA 1,6L - 19,8 X 19 X 8,2 CM",SANREMO,Em linha,R42-B02-A01-P04,155,0,60,155
55973,SR1600/33,PORTA ALCOOL GEL 280 ML,SANREMO,Em linha,R42-B01-A01-P03,386,11,0,375
55974,SR1601/33,PORTA ALCOOL GEL 480 ML,SANREMO,Promocao,R42-B02-A02-P02,591,7,0,584
42245,SR512/1,PULVERIZADOR 350ML ROSA,SANREMO,Em linha,R43-B05-A01-P03,1531,45,0,1486
42246,SR501/1,PULVERIZADOR 580ML ROSA,SANREMO,Promocao,R43-B08-A01-P03,2274,84,0,2190
15418,512,PULVERIZADOR 350 ML AZUL,SANREMO,Em linha,R46-B16-A00-P01,3025,99,0,2926
15417,501,PULVERIZADOR 580 ML AZUL,SANREMO,Promocao,R46-B15-A00-P01,5388,291,0,5097
15113,955,"TOP STOCK - ORGANIZADOR BX 4,3 LTS  26X17X14 CMS",SANREMO,Em linha,R44-B07-A02-P03,114,0,0,114
15115,963,"TOP STOCK - ORGANIZADOR 16,7 LTS  40X27X25 CMS",SANREMO,Em linha,R43-B01-A02-P01,1061,3,0,1058
15116,965,"TOP STOCK - ORGANIZADOR ALTO 26,5 LT  40X27X36 CMS",SANREMO,Em linha,R43-B10-A02-P02,71,0,0,71
15118,975,TOP STOCK - ORGANIZADOR ALTO 56 LTS   56X38X37 CMS,SANREMO,Em linha,R43-B04-A00-P01,51,0,0,51
15114,960,"TOP STOCK - ORGANIZADOR BX 8,6 LTS 40X27X13 CMS",SANREMO,Em linha,R43-B05-A02-P02,356,0,0,356
15117,970,"TOP STOCK - ORGANIZADOR BX 28,2 LTS   56X38X20 CMS",SANREMO,Em linha,R43-B04-A00-P02,298,0,0,298
15119,980,TOP STOCK - ORGANIZADOR 42 LTS  65X44X24 CMS,SANREMO,Em linha,R43-B09-A00-P02,90,0,0,90
15120,985,TOP STOCK - ORGANIZADOR ALTO 72 LTS   65X44X40 CMS,SANREMO,Em linha,R44-B07-A00-P01,145,2,0,143
32161,SR931,"FLEX - ORGANIZADOR BX 20 LTS - 19,6X33,1X48,7 CMS",SANREMO,Em linha,R43-B06-A00-P01,106,0,0,106
19100,SR941,"FLEX - ORGANIZADOR MD 29 LTS - 48,7X33,1X27,6 CMS",SANREMO,Em linha,R43-B02-A00-P01,69,0,0,69
19101,SR951,"FLEX - ORGANIZADOR ALTO 36 LTS -48,7X33,1X33,6 CMS",SANREMO,Em linha,R43-B01-A00-P02,153,0,0,153
19102,SR961,"FLEX - ORGANIZADOR BX 48 LTS - 63,1X44,1X15,6 CMS",SANREMO,Em linha,R43-B10-A00-P02,87,0,0,87
32162,SR971,"FLEX - ORGANIZADOR MD 68 LTS - 33,1X44,1X63,1 CMS",SANREMO,Em linha,R43-B09-A00-P01,74,1,0,73
32164,SR981,"FLEX - ORGANIZADOR ALTO 80 LTS -41,6X44,1X63,1 CMS",SANREMO,Em linha,R43-B02-A00-P02,39,0,0,39
57169,SR653/70,BEBEDOURO PORTATIL 330 ML AZUL,SANREMO,Lancamento,R44-B05-A02-P04,337,9,0,328
57159,SR653/71,BEBEDOURO PORTATIL 330 ML ROSA,SANREMO,Lancamento,R44-B05-A02-P03,341,9,0,332
57166,SR651/70,BEBEDOURO AUTOMATICO P/ CÃO 250 ML AZUL,SANREMO,Lancamento,R44-B06-A00-P04,304,0,0,304
57156,SR651/71,BEBEDOURO AUTOMATICO P/ CÃO 250 ML ROSA,SANREMO,Lancamento,R44-B05-A00-P02,299,0,0,299
57164,SR642/70,COMEDOURO P/ CÃO 300ML AZUL,SANREMO,Lancamento,R44-B06-A01-P04,253,9,0,244
57154,SR642/71,COMEDOURO P/ CÃO 300ML ROSA,SANREMO,Lancamento,R44-B06-A01-P03,256,12,0,244
57165,SR643/70,COMEDOURO P/ CÃO 650ML AZUL,SANREMO,Lancamento,R44-B06-A01-P06,874,444,0,430
57155,SR643/71,COMEDOURO P/ CÃO 650ML ROSA,SANREMO,Lancamento,R44-B06-A01-P05,883,432,0,451
57168,SR652/70,BEBEDOURO AUTOMATICO P/ GATO 250 ML AZUL,SANREMO,Lancamento,R44-B05-A00-P04,278,0,0,278
57158,SR652/71,BEBEDOURO AUTOMATICO P/ GATO 250 ML ROSA,SANREMO,Lancamento,R44-B05-A01-P02,395,0,0,395
57167,SR641/70,COMEDOURO P/ GATO 200ML AZUL,SANREMO,Lancamento,R44-B06-A01-P02,304,0,0,304
57157,SR641/71,COMEDOURO P/ GATO 200ML ROSA,SANREMO,Lancamento,R44-B06-A01-P01,301,0,0,301
57172,SR342/70,"CAIXA SANITARIA P/ GATO 6,4L AZUL",SANREMO,Lancamento,R44-B06-A00-P03,87,0,0,87
57162,SR342/71,"CAIXA SANITARIA P/ GATO 6,4L ROSA",SANREMO,Lancamento,R44-B05-A00-P03,112,0,0,112
57173,SR662/70,PÁ HIGIENICA P/ GATO 23 CM AZUL,SANREMO,Lancamento,R44-B05-A01-P03,513,6,0,507
57163,SR662/71,PÁ HIGIENICA P/ GATO 23 CM ROSA,SANREMO,Lancamento,R44-B05-A01-P05,522,6,0,516
57170,SR267/70,"PORTA RACAO 2,35 L AZUL",SANREMO,Lancamento,R44-B05-A00-P01,284,6,0,278
57160,SR267/71,"PORTA RACAO 2,35 L ROSA",SANREMO,Lancamento,R44-B05-A01-P04,177,7,120,170
57171,SR807/70,MEDIDOR RACAO 240 ML AZUL,SANREMO,Lancamento,R44-B06-A00-P01,336,1,0,335
57161,SR807/71,MEDIDOR RACAO 240 ML ROSA,SANREMO,Lancamento,R44-B05-A02-P02,344,1,0,343
57174,SR663,SACOLA HIGIENICA 4L C/ 03 PÇS,SANREMO,Lancamento,R44-B06-A00-P02,143,6,0,137
12030,3638,TRONINHO BABY AZUL,TRITEC,Em linha,R42-B08-A00-P02,339,20,0,319
12031,3636,TRONINHO BABY ROSA,TRITEC,Em linha,R42-B08-A00-P01,341,23,0,318
30401,3827,CJ INFANTIL EDUCATIVA MESA C/ 02 CADEIRAS ,TRITEC,Em linha,R45-B15-A00-P01,128,10,0,118
51715,4130,CJ INFANTIL EDUCATIVA MESA C/ 02 CADEIRAS MENINA,TRITEC,Em linha,R45-B15-A00-P01,107,4,0,103
8626,618,PRATO ESCOLAR FUNDO 500 ML,TRITEC,Em linha,R42-B04-A00-P02,4943,129,0,4814
8625,617,CANECA ESCOLAR 270 ML,TRITEC,Em linha,R42-B06-A02-P02,1703,12,0,1691
26120,510,"PORTA SABAO/DETERGENTE 20X11,5X6,5 CM ",TRITEC,Em linha,R42-B05-A00-P02,2197,131,0,2066
42272,310,CESTO PARA PRENDEDOR 12X26X9 CM,TRITEC,Em linha,R42-B03-A01-P02,1740,59,0,1681
30396,1047,LIXEIRA C/ PEDAL BRANCA 50 LTS,TRITEC,Em linha,R42-B07-A02-P01,114,4,180,110
26121,862,LIXEIRA QUADRADA C/ PEDAL 21 LTS,TRITEC,Em linha,R42-B08-A02-P01,89,0,0,89
33172,281,LIXEIRA REDONDA C/ PEDAL 07 LTS,TRITEC,Em linha,R42-B06-A02-P01,173,6,40,167
12039,264,MATA MOSCA SORTIDO,TRITEC,Em linha,R42-B01-A00-P02,1957,60,0,1897
51717,4131,CAÇAROLA 2 L OVAL,TRITEC,Em linha,R42-B07-A00-P02,364,6,0,358
51719,4133,"CAÇAROLA 1,6 L RETANGULAR",TRITEC,Em linha,R42-B08-A02-P02,318,6,0,312
51708,4121,"ORGANIZA HERMÉTICO COLOR 1,1L",TRITEC,Em linha,R45-B14-A00-P01,3787,792,276,2995
51707,4120,"ORGANIZA HERMÉTICO COLOR 2,0L",TRITEC,Em linha,R42-B05-A01-P01,2065,207,600,1858
51706,4119,"ORGANIZA HERMÉTICO COLOR 3,1L",TRITEC,Em linha,R42-B04-A01-P01,2863,155,0,2708
51705,4118,"ORGANIZA HERMÉTICO COLOR 4,7L",TRITEC,Em linha,R42-B03-A00-P01,2126,111,0,2015
39537,3354,"BACIA C/ TAMPA 1,2 L",TRITEC,Em linha,R42-B03-A00-P02,1882,158,0,1724
39538,3355,"BACIA C/ TAMPA 2,2 L",TRITEC,Em linha,R42-B07-A01-P01,1410,89,0,1321
46896,3929,"KIT BACIA C/ ALÇA C/ 2 - 2,1 L",TRITEC,Em linha,R42-B03-A02-P01,865,23,90,842
12609,2940,"BACIA C/ TAMPA E ALCA 3,6 LTS",TRITEC,Em linha,R42-B10-A00-P02,1646,81,0,1565
12608,2939,BACIA C/ TAMPA E ALCA 10 LTS,TRITEC,Em linha,R42-B10-A01-P01,2020,76,0,1944
51712,4126,KIT C/ 3 ORGANIZA FACIL BX 1700 ML COLOR,TRITEC,Em linha,R42-B10-A00-P01,338,12,0,326
51713,4127,KIT C/ 3 ORGANIZA FACIL ALTO 1000 ML COLOR,TRITEC,Em linha,R42-B02-A02-P02,481,10,0,471
51714,4129,KIT C/ 3 ORGANIZA FACIL BX 800 ML COLOR,TRITEC,Em linha,R42-B05-A02-P01,528,20,0,508
23541,445,"FUNIL GRANDE 10 X 10,5 CM",TRITEC,Em linha,R42-B08-A00-P03,8456,624,0,7832
46898,458,KIT FUNIL C/ 2,TRITEC,Em linha,R42-B09-A00-P01,795,50,0,745
39540,3273,ESCORREDOR LAVA TUDO,TRITEC,Em linha,R42-B06-A00-P03,921,45,0,876
38283,3327,"BACIA PARA MASSA 4,5 L",TRITEC,Em linha,R42-B05-A02-P02,389,6,0,383
5622,403,PILAO P/CAIPIRINHA 500 ML,TRITEC,Em linha,R42-B05-A01-P02,1137,34,0,1103
10389,1005,COPO PS CRISTAL TRANSLUCIDO GRADUADO 550 ML,TRITEC,Em linha,R42-B06-A01-P02,591,30,0,561
37127,366,SALEIRO 1 KG,TRITEC,Em linha,R42-B09-A02-P01,1475,18,0,1457
26104,508,POTE MULTIUSO 900 ML   COLOR,TRITEC,Em linha,R42-B04-A00-P01,908,30,0,878
40588,491,CJ C/ 03 BISNAGAS VM/AM/BR,TRITEC,Em linha,R42-B04-A02-P01,2264,98,960,2166
5621,396,BISNAGA BRANCA 200 ML,TRITEC,Em linha,R42-B09-A01-P02,4355,792,9000,3563
5619,394,BISNAGA VERMELHA 200 ML,TRITEC,Em linha,R42-B08-A01-P01,2566,936,10800,1630
5620,395,BISNAGA AMARELA 200 ML,TRITEC,Em linha,R42-B01-A00-P01,11139,540,0,10599
26116,866,JARRA GRADUADA 1000 ML    ,TRITEC,Em linha,R42-B06-A01-P01,749,24,0,725
26118,1092,"GARRAFA P/ AGUA 1,1 LTS   ",TRITEC,Em linha,R42-B07-A00-P01,462,30,0,432
26117,697,GARRAFA P/ AGUA 2 LT    ,TRITEC,Em linha,R42-B06-A00-P01,531,6,0,525
26119,398,JARRA C/ TAMPA 4 LT,TRITEC,Em linha,R42-B05-A00-P01,309,11,120,298
46897,662,KIT PENEIRA C/ 3 P M G BRANCA,TRITEC,Em linha,R42-B07-A01-P02,1304,6,0,1298
10799,659,PENEIRA GRANDE 29 X 16 X 8 CM,TRITEC,Em linha,R42-B03-A01-P01,4552,274,0,4278
12037,660,PENEIRA MEDIA 22 X 10 X 5 CM,TRITEC,Em linha,R42-B09-A01-P01,2761,234,1800,2527
12038,661,"PENEIRA PEQUENA 17,5 X 7 X 3,5 CM",TRITEC,Em linha,R42-B04-A01-P02,2759,192,0,2567
52651,UZ376-TR,"ORGANIZADOR DE GAVETA 8,5 X 17 CM",UZ UTILIDADES,Em linha,R45-B03-A01-P02,113,0,60,113
52650,UZ378-TR,"ORGANIZADOR DE GAVETA 8,5 X 25,5 CM",UZ UTILIDADES,Em linha,R45-B03-A01-P04,185,1,180,184
52649,UZ380-TR,"ORGANIZADOR DE GAVETA 17 X 25,5 CM",UZ UTILIDADES,Em linha,R45-B02-A01-P02,255,2,0,253
52647,UZ382-TR,"ORGANIZADOR DE GAVETA DIVISÓRIAS 12,5 X 34 CM",UZ UTILIDADES,Em linha,R44-B01-A02-P01,303,0,0,303
52648,UZ384-TR,"ORGANIZADOR DE GAVETA 12,5 X 34 CM FACAS",UZ UTILIDADES,Em linha,R45-B04-A00-P02,83,7,180,76
52645,UZ392-TR,ORGANIZADOR 20 X 25 CM,UZ UTILIDADES,Em linha,R45-B08-A02-P01,179,7,60,172
52646,UZ388-TR,ORGANIZADOR C/ DIV 18 X 28 CM,UZ UTILIDADES,Em linha,R45-B01-A01-P01,85,6,60,79
52644,UZ390-TR,ORGANIZADOR 20 X 20 CM,UZ UTILIDADES,Em linha,R45-B08-A02-P02,165,0,0,165
46847,UZ285-VM,KIT PORTA MANTIMENTOS C/ 5 PCS VERMELHO ,UZ UTILIDADES,Em linha,R45-B02-A02-P02,45,0,0,45
36997,UZ212-VM,MULTIUSO PREMIUM 10 L VERMELHO,UZ UTILIDADES,Em linha,R44-B04-A02-P03,39,0,60,39
40462,UZ257-VM,"MULTIUSO PREMIUM 5,5L VERMELHO",UZ UTILIDADES,Em linha,R44-B02-A02-P01,58,0,60,58
40460,UZ256-VM,"MULTIUSO PREMIUM 1,5L VERMELHO",UZ UTILIDADES,Em linha,R45-B03-A01-P01,41,3,90,38
36989,UZ202-VM,MULTIUSO PREMIUM 6 L VERMELHO,UZ UTILIDADES,Em linha,R45-B04-A02-P01,27,1,90,26
36991,UZ203-VM,MULTIUSO PREMIUM 4L VERMELHO,UZ UTILIDADES,Em linha,R45-B05-A02-P04,90,6,60,84
36993,UZ204-VM,MULTIUSO PREMIUM 2L VERMELHO,UZ UTILIDADES,Em linha,R45-B04-A01-P02,35,3,180,32
36995,UZ206-VM,"MULTIUSO PREMIUM 0,8L VERMELHO",UZ UTILIDADES,Em linha,R45-B03-A02-P01,111,18,60,93
38231,UZ210-VM,"MULTIUSO PREMIUM 2,5 L VERMELHO",UZ UTILIDADES,Promocao,R44-B04-A01-P01,53,3,0,50
37005,UZ227-VM,MULTIUSO RETANGULAR 5L VERMELHO,UZ UTILIDADES,Em linha,R45-B06-A02-P02,105,6,60,99
37003,UZ226-VM,MULTIUSO RETANGULAR 3L VERMELHO,UZ UTILIDADES,Em linha,R45-B08-A01-P03,103,6,30,97
37001,UZ225-VM,"MULTIUSO RETANGULAR 1,5L VERMELHO",UZ UTILIDADES,Em linha,R45-B07-A02-P01,77,23,90,54
37016,UZ250-VM,MULTIUSO RETANGULAR 500ML VERMELHO,UZ UTILIDADES,Em linha,R44-B01-A01-P04,99,6,180,93
46838,UZ294-VM,MULTIUSO QUADRADO 5L VERMELHO ,UZ UTILIDADES,Em linha,R45-B01-A02-P01,100,3,30,97
46840,UZ295-VM,"MULTIUSO QUADRADO 2,5L VERMELHO ",UZ UTILIDADES,Em linha,R45-B01-A02-P03,143,4,30,139
46842,UZ296-VM,"MULTIUSO QUADRADO 1,5L VERMELHO ",UZ UTILIDADES,Em linha,R45-B03-A01-P05,97,14,90,83
46844,UZ297-VM,"MULTIUSO QUADRADO 0,5L VERMELHO ",UZ UTILIDADES,Em linha,R45-B07-A02-P03,141,12,120,129
56443,UZ398-VM,MULTIUSO RETANGULAR 3L VERMELHO - 11 X 24 X 16 CM,UZ UTILIDADES,Em linha,R44-B02-A00-P01,452,18,180,434
56442,UZ397-VM,MULTIUSO RETANGULAR 2L VERMELHO - 10 X 21 X 14 CM,UZ UTILIDADES,Em linha,R45-B06-A00-P02,391,33,180,358
56441,UZ396-VM,MULTIUSO RETANGULAR 1L VERMELHO - 7 X 18 X 12 CM,UZ UTILIDADES,Em linha,R44-B04-A00-P04,124,22,360,102
48482,UZ660-VM,"JARRA GOLD 1,5L VERMELHO",UZ UTILIDADES,Em linha,R44-B01-A01-P05,100,0,0,100
36977,UZ158-VM,"JARRA PLUS 1,8L VERMELHO",UZ UTILIDADES,Em linha,R45-B03-A00-P01,95,6,240,89
36981,UZ161-VM,CANECA CAPPUCCINO PLUS 400ML VERMELHO,UZ UTILIDADES,Em linha,R44-B04-A02-P02,324,0,0,324
36975,UZ145-VM,SALEIRO 500ML VERMELHO,UZ UTILIDADES,Promocao,R44-B01-A02-P02,36,9,360,27
36987,UZ195-VM,PORTA BOLO PLUS VERMELHO,UZ UTILIDADES,Em linha,R45-B06-A02-P01,41,9,0,32
38224,UZ335-VM,ESCORREDOR DE LOUCA VAZADO VERMELHO,UZ UTILIDADES,Em linha,R45-B07-A02-P02,50,0,60,50
38228,UZ350-VM,LIXEIRA 4L VERMELHO,UZ UTILIDADES,Promocao,R45-B02-A00-P01,145,11,0,134
48479,UZ367-VM,DISPENSER VERMELHO PESCANTE METAL. 600 ML,UZ UTILIDADES,Em linha,R45-B02-A00-P02,90,5,180,85
38222,UZ354-VM,DISPENSER VERMELHO TRANSLUCIDO PESCANTE METAL 600,UZ UTILIDADES,Em linha,R44-B01-A00-P03,415,6,0,409
38242,UZ322-VM,ORGANIZADOR DE PIA PLUS VERMELHO,UZ UTILIDADES,Em linha,R44-B03-A00-P01,255,1,0,254
39549,UZ358-VM,DISPENSER PREMIUM VERMELHO TRANSLUCIDO 600 ML,UZ UTILIDADES,Promocao,R45-B06-A01-P01,130,0,0,130
56440,UZ400-VM,DISPENSER SLIM VERMELHO TRANSL. - 9 X 18 CM,UZ UTILIDADES,Promocao,R45-B05-A02-P03,635,2,540,633
45340,UZ522-VM,PORTA SABONETE LIQ. PREMIUM VERMELHO TRANSLUCIDO,UZ UTILIDADES,Promocao,R44-B03-A01-P04,486,0,0,486
45341,UZ520-VM,PORTA ESCOVA C/ TAMPA PREMIUM VERMELHO TRANS,UZ UTILIDADES,Promocao,R44-B03-A01-P02,155,0,0,155
36996,UZ212-ROS,MULTIUSO PREMIUM 10L ROSA,UZ UTILIDADES,Em linha,R45-B04-A02-P02,76,0,0,76
40463,UZ257-ROS,"MULTIUSO PREMIUM 5,5L ROSA",UZ UTILIDADES,Em linha,R45-B01-A01-P04,88,0,0,88
40461,UZ256-ROS,"MULTIUSO PREMIUM 1,5L ROSA",UZ UTILIDADES,Em linha,R44-B01-A01-P01,100,0,0,100
36988,UZ202-ROS,MULTIUSO PREMIUM 6 L ROSA,UZ UTILIDADES,Em linha,R45-B03-A02-P03,53,1,30,52
36990,UZ203-ROS,MULTIUSO PREMIUM 4L ROSA,UZ UTILIDADES,Em linha,R45-B05-A02-P02,120,0,0,120
36992,UZ204-ROS,MULTIUSO PREMIUM 2L ROSA,UZ UTILIDADES,Em linha,R45-B01-A01-P03,163,4,0,159
36994,UZ206-ROS,"MULTIUSO PREMIUM 0,8L ROSA",UZ UTILIDADES,Em linha,R44-B02-A01-P01,122,16,30,106
38234,UZ211-ROS,MULTIUSO PREMIUM 5L ROSA,UZ UTILIDADES,Promocao,R44-B04-A00-P02,30,0,0,30
38230,UZ210-ROS,"MULTIUSO PREMIUM 2,5 L ROSA",UZ UTILIDADES,Promocao,R44-B01-A00-P01,96,0,0,96
46837,UZ294-ROS,MULTIUSO QUADRADO 5L ROSA,UZ UTILIDADES,Em linha,R45-B02-A02-P03,146,0,0,146
46839,UZ295-ROS,"MULTIUSO QUADRADO 2,5L ROSA ",UZ UTILIDADES,Em linha,R45-B02-A01-P04,259,7,0,252
46841,UZ296-ROS,"MULTIUSO QUADRADO 1,5L ROSA ",UZ UTILIDADES,Em linha,R45-B04-A01-P04,134,5,0,129
37004,UZ227-ROS,MULTIUSO RETANGULAR 5L ROSA,UZ UTILIDADES,Em linha,R44-B04-A00-P01,97,11,0,86
37002,UZ226-ROS,MULTIUSO RETANGULAR 3L ROSA,UZ UTILIDADES,Em linha,R44-B03-A01-P01,205,15,0,190
37000,UZ225-ROS,"MULTIUSO RETANGULAR 1,5L ROSA",UZ UTILIDADES,Em linha,R45-B06-A01-P04,161,19,0,142
37015,UZ250-ROS,MULTIUSO RETANGULAR 500ML ROSA,UZ UTILIDADES,Em linha,R45-B02-A01-P01,97,25,0,72
37011,UZ244-ROS,PORTA PÃO PREMIUM ROSA  COM TAMPA,UZ UTILIDADES,Em linha,R45-B01-A02-P02,34,11,10,23
36986,UZ195-ROS,PORTA BOLO PLUS ROSA,UZ UTILIDADES,Em linha,R45-B05-A02-P01,78,2,0,76
38223,UZ335-ROS,ESCORREDOR DE LOUCA VAZADO ROSA,UZ UTILIDADES,Em linha,R45-B03-A02-P02,22,2,90,20
36974,UZ145-ROS,SALEIRO 500ML ROSA,UZ UTILIDADES,Promocao,R45-B05-A00-P02,93,9,300,84
38227,UZ350-ROS,LIXEIRA 4L ROSA,UZ UTILIDADES,Promocao,R45-B04-A00-P01,82,11,90,71
36976,UZ158-ROS,"JARRA PLUS 1,8L ROSA",UZ UTILIDADES,Em linha,R45-B01-A01-P02,189,5,0,184
48481,UZ660-ROS,"JARRA GOLD 1,5L ROSA",UZ UTILIDADES,Em linha,R45-B08-A01-P02,69,3,120,66
38241,UZ322-ROS,ORGANIZADOR DE PIA PLUS ROSA,UZ UTILIDADES,Em linha,R45-B04-A00-P03,241,3,0,238
39546,UZ358-ROS,DISPENSER PREMIUM ROSA TRANSLUCIDO 600 ML,UZ UTILIDADES,Promocao,R45-B06-A01-P02,205,0,0,205
48478,UZ367-ROS,DISPENSER ROSA PESCANTE METAL. 600 ML,UZ UTILIDADES,Em linha,R44-B01-A02-P03,40,19,180,21
37024,UZ354-ROS,DISPENSER ROSA TRANSLUCIDO PESCANTE METAL. 600 ML,UZ UTILIDADES,Em linha,R45-B03-A00-P02,468,4,90,464
56438,UZ400-ROS,DISPENSER SLIM ROSA TRANSL. - 9 X 18 CM,UZ UTILIDADES,Promocao,R45-B07-A00-P01,1059,62,0,997
37026,UZ520-ROS,PORTA ESCOVA C/ TAMPA PREMIUM ROSA TRANS,UZ UTILIDADES,Promocao,R44-B04-A01-P02,182,3,120,179
37028,UZ522-ROS,PORTA SABONETE LIQ. PREMIUM ROSA TRANS,UZ UTILIDADES,Promocao,R45-B04-A01-P05,496,51,0,445
49866,UZ522-BR,PORTA SABONETE LIQ. PREMIUM BRANCO,UZ UTILIDADES,Promocao,R45-B05-A01-P02,314,50,30,264
49865,UZ520-BR,PORTA ESCOVA C/ TAMPA PREMIUM BRANCO,UZ UTILIDADES,Promocao,R45-B07-A01-P03,122,3,0,119
49863,UZ350-BR,LIXEIRA 4L BRANCO,UZ UTILIDADES,Promocao,R45-B06-A00-P01,186,2,0,184
39547,UZ358-TR,DISPENSER PREMIUM TRANSP TRANSLUCIDO 600 ML,UZ UTILIDADES,Promocao,R45-B06-A01-P03,105,0,0,105
49864,UZ367-BR,DISPENSER BRANCO PESCANTE METAL. 600 ML,UZ UTILIDADES,Em linha,R45-B01-A00-P02,419,52,120,367
38219,UZ354-TR,DISPENSER TRANSP TRANSLUCIDO PESCANTE METAL 600 ML,UZ UTILIDADES,Em linha,R44-B03-A02-P04,776,14,0,762
56439,UZ400-TR,DISPENSER SLIM TRANSLUCIDO - 9 X 18 CM,UZ UTILIDADES,Promocao,R44-B04-A02-P01,979,40,600,939
37023,UZ354-PR,DISPENSER PRETO TRANSLUCIDO PESCANTE METAL. 600 ML,UZ UTILIDADES,Em linha,R45-B05-A00-P03,592,7,240,585
56437,UZ400-PR,DISPENSER SLIM PRETO TRANSL. - 9 X 18 CM,UZ UTILIDADES,Promocao,R45-B06-A02-P03,902,50,600,852
48477,UZ367-PR,DISPENSER PRETO PESCANTE METAL. 600 ML,UZ UTILIDADES,Em linha,R44-B01-A02-P04,485,78,600,407
54860,UZ202-AMC,MULTIUSO PREMIUM 6 L AMARELO,UZ UTILIDADES,Em linha,R44-B02-A02-P02,40,7,0,33
54861,UZ203-AMC,MULTIUSO PREMIUM 4L AMARELO,UZ UTILIDADES,Em linha,R44-B04-A00-P03,56,7,0,49
54862,UZ204-AMC,MULTIUSO PREMIUM 2L AMARELO,UZ UTILIDADES,Em linha,R44-B03-A02-P03,96,7,0,89
54863,UZ206-AMC,"MULTIUSO PREMIUM 0,8L AMARELO",UZ UTILIDADES,Em linha,R45-B08-A02-P03,247,19,0,228
54866,UZ227-AMC,MULTIUSO RETANGULAR 5L AMARELO,UZ UTILIDADES,Em linha,R44-B03-A00-P02,54,0,0,54
54865,UZ226-AMC,MULTIUSO RETANGULAR 3L AMARELO,UZ UTILIDADES,Em linha,R44-B03-A02-P01,1370,0,0,1370
54864,UZ225-AMC,"MULTIUSO RETANGULAR 1,5L AMARELO",UZ UTILIDADES,Em linha,R44-B01-A01-P03,97,0,0,97
54867,UZ250-AMC,MULTIUSO RETANGULAR 500ML AMARELO,UZ UTILIDADES,Em linha,R45-B04-A01-P03,134,0,0,134
54868,UZ294-AMC,MULTIUSO QUADRADO 5L AMARELO ,UZ UTILIDADES,Em linha,R45-B02-A02-P01,100,2,0,98
54869,UZ295-AMC,"MULTIUSO QUADRADO 2,5L AMARELO ",UZ UTILIDADES,Em linha,R44-B02-A01-P03,50,2,0,48
54870,UZ296-AMC,"MULTIUSO QUADRADO 1,5L AMARELO ",UZ UTILIDADES,Em linha,R45-B07-A02-P04,84,3,0,81
54871,UZ322-AMC,ORGANIZADOR DE PIA PLUS AMARELO,UZ UTILIDADES,Em linha,R45-B05-A01-P03,333,2,0,331
54859,UZ158-AMC,"JARRA PLUS 1,8L AMARELO",UZ UTILIDADES,Em linha,R44-B02-A00-P02,101,2,120,99
54873,UZ367-AMC,DISPENSER AMARELO PESCANTE METAL. 600 ML,UZ UTILIDADES,Em linha,R45-B01-A00-P03,77,13,180,64
54872,UZ350-AMC,LIXEIRA 4L AMARELO,UZ UTILIDADES,Promocao,R45-B05-A00-P01,135,9,0,126
56432,UZ543-ROSE,"PORTA ESCOVA C/ TAMPA METALIZADO - 7,5 X 22 CM",UZ UTILIDADES,Promocao,R45-B05-A01-P04,353,7,0,346
56433,UZ545-ROSE,"PORTA SABONETE LIQUIDO METALIZADO - 7,5 X 13,5 CM",UZ UTILIDADES,Em linha,R45-B04-A01-P01,308,9,0,299
56431,UZ546-ROSE,"PORTA ALGODÃO / COTONETE METALIZADO - 7,5 X 12 CM",UZ UTILIDADES,Promocao,R44-B04-A01-P03,271,2,0,269
42296,UZ528-ROSE,PORTA SABONETE LIQ. PREMIUM ROSE TRANSL,UZ UTILIDADES,Promocao,R45-B03-A01-P03,341,4,0,337
42295,UZ526-ROSE,PORTA ESCOVA C/ TAMPA PREMIUM ROSE TRANSL,UZ UTILIDADES,Promocao,R45-B02-A01-P03,213,6,0,207
56435,UZ543-ONIX,"PORTA ESCOVA C/ TAMPA ONIX - 7,5 X 22 CM",UZ UTILIDADES,Promocao,R45-B07-A00-P02,172,8,160,164
56436,UZ545-ONIX,"PORTA SABONETE LIQUIDO ONIX - 7,5 X 13,5 CM",UZ UTILIDADES,Em linha,R45-B07-A01-P04,207,11,120,196
56434,UZ546-ONIX,"PORTA ALGODAO / COTONETE ONIX - 7,5 X 12,7 CM",UZ UTILIDADES,Promocao,R45-B07-A01-P01,237,5,0,232
37027,UZ522-PR,PORTA SABONETE LIQ. PREMIUM PRETO TRANSLUCIDO,UZ UTILIDADES,Promocao,R44-B01-A00-P02,459,49,0,410
37025,UZ520-PR,PORTA ESCOVA C/ TAMPA PREMIUM PRETO TRANS,UZ UTILIDADES,Promocao,R45-B05-A01-P01,201,56,150,145
56429,UZ538-PR,"PORTA ESCOVA C/ TAMPA FUME - 7,5 X 22 CM",UZ UTILIDADES,Em linha,R44-B03-A02-P02,37,2,120,35
56430,UZ540-PR,"PORTA SABONETE LIQUIDO FUME - 7,5 X 13,5 CM",UZ UTILIDADES,Em linha,R45-B07-A01-P02,275,0,0,275
56428,UZ541-PR,"PORTA ALGODÃO / COTONETE FUME - 7,5 X 12,7 CM",UZ UTILIDADES,Promocao,R44-B02-A01-P02,152,0,0,152
45342,UZ528-PRDR,PORTA SABONETE LIQ. PREMIUM PRETO / DOURADO,UZ UTILIDADES,Promocao,R44-B03-A01-P03,168,3,0,165
45343,UZ526-PRDR,PORTA ESCOVA C/ TAMPA PREMIUM PRETO /DOURADO,UZ UTILIDADES,Promocao,R44-B03-A00-P03,125,2,0,123
54874,UZ1847-TR,DISPENSER ALCOOL EM GEL 300 ML,UZ UTILIDADES,Promocao,R44-B01-A01-P02,233,5,0,228
37029,UZ532-PRDR,KIT HIGIENE PREMIUM PRETO DOURADO,UZ UTILIDADES,Promocao,R45-B08-A01-P01,63,0,0,63
57179,470450,SQUEEZE BODY 1L MICKEY,PLASDURAN,Lancamento,R47-B08-A01-P02,169,9,60,160
42182,470912,GARRAFA PET 700ML MICKEY MOUSE,PLASDURAN,Em linha,R47-B04-A02-P02,127,6,240,121
57178,470451,SQUEEZE BODY 1L MINNIE,PLASDURAN,Lancamento,R48-B06-A00-P03,215,6,0,209
42183,470913,GARRAFA PET 700ML MINNIE MOUSE,PLASDURAN,Em linha,R47-B09-A02-P02,142,18,240,124
42353,470893,GARRAFA PET SLEEVE 550 ML MINIE,PLASDURAN,Em linha,R48-B09-A01-P03,368,0,240,368
52506,470539,GARRAFA PET PARIS 600ML MICKEY,PLASDURAN,Promocao,R48-B06-A00-P01,923,36,0,887
35706,470866,GARRAFA PET SLEEVE 550 ML MICKEY MOUSE,PLASDURAN,Em linha,R47-B03-A02-P01,466,0,0,466
52507,470542,GARRAFA PET PARIS 600ML MINNIE,PLASDURAN,Promocao,R48-B08-A01-P02,908,42,0,866
19621,470801,GARRAFA SLEEVE 250 ML MICKEY MOUSE,PLASDURAN,Promocao,R48-B07-A00-P03,1246,22,150,1224
21565,441637,CANECA 400 ML MICKEY MOUSE ,PLASDURAN,Em linha,R48-B07-A01-P01,343,21,240,322
19622,470802,GARRAFA SLEEVE 250 ML MINNIE MOUSE,PLASDURAN,Promocao,R47-B06-A02-P01,1221,34,600,1187
21566,441638,CANECA 400 ML MINNIE MOUSE ,PLASDURAN,Em linha,R48-B07-A01-P02,655,29,0,626
51693,470921,GARRAFA PET 700ML PRINCESAS,PLASDURAN,Em linha,R47-B06-A00-P02,87,9,60,78
52511,470543,GARRAFA PET PARIS 600ML PRINCESAS,PLASDURAN,Promocao,R48-B07-A00-P01,633,20,0,613
42355,470888,GARRAFA PET SLEEVE 550 ML PRINCESAS,PLASDURAN,Em linha,R48-B06-A01-P01,381,21,0,360
19624,470804,GARRAFA SLEEVE 250 ML PRINCESAS ,PLASDURAN,Promocao,R47-B10-A00-P01,918,25,0,893
21569,441639,CANECA 400 ML PRINCESAS ,PLASDURAN,Em linha,R48-B07-A01-P03,330,35,0,295
51691,470922,GARRAFA PET 700ML MARVEL,PLASDURAN,Em linha,R47-B05-A00-P02,97,5,120,92
52508,470544,GARRAFA PET PARIS 600ML MARVEL,PLASDURAN,Promocao,R48-B07-A02-P01,603,20,0,583
42351,470892,GARRAFA PET SLEEVE 550 ML MARVEL,PLASDURAN,Em linha,R48-B06-A00-P02,526,9,0,517
28120,470814,GARRAFA SLEEVE 250 ML MARVEL COMICS,PLASDURAN,Promocao,R48-B06-A01-P03,817,47,900,770
51692,470928,GARRAFA PET 700ML FROZEN,PLASDURAN,Em linha,R48-B08-A02-P03,50,0,120,50
52509,470547,GARRAFA PET PARIS 600ML FROZEN 2,PLASDURAN,Promocao,R47-B08-A02-P02,530,12,0,518
42350,470998,GARRAFA PET SLEEVE 550 ML FROZEN,PLASDURAN,Em linha,R48-B06-A02-P03,269,0,0,269
24419,470812,GARRAFA SLEEVE 250 ML FROZEN,PLASDURAN,Promocao,R48-B06-A02-P03,1033,30,0,1003
46869,470930,GARRAFA PET 700 ML UNICORNIO,PLASDURAN,Em linha,R47-B08-A00-P02,244,3,0,241
39438,470899,GARRAFA PET SLEEVE 550 ML UNICORNIO,PLASDURAN,Promocao,R47-B08-A02-P01,930,6,0,924
39319,470800,GARRAFA SLEEVE 250 ML UNICORNIO,PLASDURAN,Em linha,R48-B06-A01-P02,988,73,870,915
40567,470139    ,COPO 220 ML UNICORNIO C/ALÇA E SOBRE TAMPA ,PLASDURAN,Em linha,R48-B10-A01-P02,1547,26,0,1521
38201,470138,COPO 220 ML KIDS C/ALÇA E SOBRE TAMPA ,PLASDURAN,Em linha,R48-B10-A00-P02,1319,18,0,1301
46878,470931,GARRAFA PET 700 ML PANDA,PLASDURAN,Em linha,R48-B09-A01-P02,317,5,0,312
17340,470351,GARRAFA SLEEVE 250 ML URSINHO ,PLASDURAN,Em linha,R48-B06-A02-P02,1687,82,0,1605
28124,470658,GARRAFA SLEEVE 250 ML SAFARI ,PLASDURAN,Em linha,R48-B05-A01-P03,779,130,1350,649
39317,470667 PP,GARRAFA SLEEVE 250 ML PALHAÇO MENINA,PLASDURAN,Em linha,R47-B04-A02-P03,1861,84,0,1777
39318,470666 PP,GARRAFA SLEEVE 250 ML PALHAÇO MENINO,PLASDURAN,Em linha,R48-B06-A02-P01,1365,64,240,1301
38211,470634,GARRAFA SLEEVE 250ML CIRCO,PLASDURAN,Em linha,R47-B10-A01-P01,1738,67,0,1671
39314,470635,GARRAFA SLEEVE 250 ML DOGS,PLASDURAN,Em linha,R47-B10-A01-P03,630,134,600,496
12214,440125,COPO 325 ML INFANTIL C/ TAMPA ,PLASDURAN,Em linha,R48-B08-A00-P01,1723,90,110,1633
22359,440108,COPO 250 ML BABY ,PLASDURAN,Em linha,R48-B09-A02-P01,1021,24,600,997
31379,470128,COPO 250 ML CHUQUINHA C/ SOBRE TAMPA,PLASDURAN,Em linha,R47-B06-A02-P02,778,36,420,742
14117,470124,COPO 250 ML CHUQUINHA,PLASDURAN,Promocao,R48-B10-A01-P03,672,42,300,630
48540,470581,GARRAFA PET 550 ML HIMALAIA LISA,PLASDURAN,Em linha,R48-B10-A02-P03,1947,106,0,1841
52514,470537,GARRAFA PET PARIS 600ML FRASES,PLASDURAN,Em linha,R48-B08-A01-P01,1442,56,500,1386
21676,430190,GARRAFA SLEEVE 550 ML ICE,PLASDURAN,Promocao,R47-B04-A00-P01,368,36,450,332
11133,470511,GARRAFA SQUEEZE 500 ML ESPORTIVA COLOR ,PLASDURAN,Promocao,R47-B06-A01-P01,868,55,720,813
29342,430282,GARRAFA SQUEEZE 400 ML RED (GALAOZINHO),PLASDURAN,Em linha,R48-B05-A01-P01,413,30,540,383
32131,430300,GARRAFA SQUEEZE 300 ML LISA ,PLASDURAN,Em linha,R47-B10-A00-P03,2569,12,1200,2557
51689,470593,GARRAFA PET APTAR C/ALÇA 600ML,PLASDURAN,Em linha,R48-B05-A02-P03,889,18,720,871
34146,430283,GARRAFA PET APTAR REDONDA 500 ML,PLASDURAN,Em linha,R48-B05-A02-P01,818,30,500,788
56665,470492,GARRAFA SQUEEZE 1L TRANSLUCIDA LISA,PLASDURAN,Em linha,R47-B09-A01-P01,1451,156,600,1295
56666,470491,GARRAFA SQUEEZE 1L FECHADA LISA,PLASDURAN,Em linha,R47-B09-A00-P01,1196,50,360,1146
56140,470469,GARRAFA SQUEEZE 750 ML TRANSLUCIDA LISA,PLASDURAN,Em linha,R48-B07-A02-P02,1681,140,360,1541
56139,470470,GARRAFA SQUEEZE 750 ML FECHADA LISA,PLASDURAN,Em linha,R48-B08-A01-P03,1522,43,0,1479
54949,470509,GARRAFA PET 700 ML MÃES,PLASDURAN,Em linha,R47-B07-A00-P01,1292,0,0,1292
54950,470605,GARRAFA PET PARIS 600ML MÃES,PLASDURAN,Em linha,R47-B08-A00-P03,1091,0,0,1091
57177,470452,SQUEEZE BODY 1L TIPOGRÁFICA,PLASDURAN,Lancamento,R47-B08-A00-P02,402,10,300,392
56663,470569,SQUEEZE PORTA COMPRIMIDO 700 ML,PLASDURAN,Em linha,R47-B09-A01-P02,389,50,0,339
56664,470570,SHAKEIRA PORTA COMPRIMIDO 750 ML,PLASDURAN,Em linha,R47-B09-A00-P02,117,27,60,90
51690,470597,SHAKEIRA PET C/TELA 900ML,PLASDURAN,Em linha,R48-B08-A02-P01,573,57,140,516
57180,470561,SHAKEIRA 520 ML TRIPLO COMPARTIMENTO,PLASDURAN,Lancamento,R47-B07-A01-P02,337,15,0,322
57176,470463,PORTA COMPRIMIDO,PLASDURAN,Lancamento,R47-B08-A01-P01,216,20,180,196
57175,470562,KIT C/ 20 PEÇAS GARRAFA PET 700 ML SORT,PLASDURAN,Lancamento,R47-B08-A01-P03,110,5,70,105
52020,470798,GARRAFA PET 700 ML FÉ,PLASDURAN,Em linha,R47-B03-A02-P03,1160,40,1000,1120
52021,470550,GARRAFA PET 700 ML FRASES,PLASDURAN,Em linha,R48-B08-A02-P02,511,17,120,494
45362,470914,GARRAFA PET 700 ML LONDON / PARIS,PLASDURAN,Em linha,R47-B03-A02-P02,706,18,0,688
45364,470920,GARRAFA PET 700 ML LISA,PLASDURAN,Em linha,R48-B09-A01-P01,571,14,0,557
49933,470591,GARRAFA PET ROCCI 700 ML,PLASDURAN,Promocao,R47-B10-A01-P02,1590,65,0,1525
48535,470948,GARRAFA PET 700 ML MONALISA,PLASDURAN,Em linha,R48-B09-A02-P02,326,41,200,285
34138,470853,GARRAFA PET ESPORTIVA BODY 1000 ML,PLASDURAN,Em linha,R48-B09-A00-P02,464,25,0,439
34147,470852,GARRAFA PET ESPORTIVA FITNESS 1000 ML,PLASDURAN,Em linha,R48-B10-A00-P01,1010,78,0,932
48536,470950,GARRAFA PET ESPORTIVA FITNESS 750 ML,PLASDURAN,Promocao,R47-B08-A00-P01,1589,47,0,1542
34139,470854,GARRAFA PET ESPORTIVA SHAKE 800 ML,PLASDURAN,Em linha,R48-B09-A00-P01,335,4,0,331
42348,470862,GARRAFA PET ESP FRESCH 750 ML,PLASDURAN,Em linha,R47-B04-A00-P02,254,3,0,251
35704,470873,GARRAFA PET ESPORT SUNNY C/ TUBO P/GELO 900 ML,PLASDURAN,Em linha,R47-B04-A02-P01,298,12,80,286
35705,430289,GARRAFA PET RED C/ ALCA E TUBO P/ GELO 1000 ML,PLASDURAN,Em linha,R47-B05-A00-P01,946,18,0,928
34154,430285,GARRAFA PET REDONDA 1000 ML,PLASDURAN,Em linha,R47-B05-A01-P01,1401,10,0,1391
34136,470855,GARRAFA PET ESP POWER C/TUBO DE GELO 650 ML,PLASDURAN,Em linha,R47-B09-A02-P03,319,12,80,307
34133,470833,GARRAFA PET ESP FRESCH C/TUBO DE GELO 550 ML,PLASDURAN,Em linha,R48-B08-A00-P03,3580,87,0,3493
34132,470838,GARRAFA PET ESP FORCE C/TUBO DE GELO 680 ML,PLASDURAN,Em linha,R48-B08-A00-P02,218,6,90,212
48537,445421,"JARRA RATTAN 1,6 L",PLASDURAN,Em linha,R47-B10-A02-P01,889,12,0,877
33135,430270,GARRAFA D'AGUA 02 LTS FRUTAS,PLASDURAN,Promocao,R47-B05-A02-P01,1413,9,0,1404
17345,430280,"GARRAFA D'AGUA 1,4 LTS FRUTAS",PLASDURAN,Em linha,R47-B06-A01-P02,296,0,240,296
39439,430206,"JARRA 1,7 LITROS TROPICAL",PLASDURAN,Promocao,R48-B10-A01-P01,378,15,0,363
13234,440103,COPO 450 ML GRADUADO C/ TAMPA ,PLASDURAN,Em linha,R48-B05-A02-P02,415,3,0,412
51695,440719,BISNAGA 350 ML KETCHUP,PLASDURAN,Em linha,R47-B06-A00-P01,1926,111,0,1815
51694,440720,BISNAGA 350 ML MAIONESE,PLASDURAN,Em linha,R47-B05-A01-P03,2174,195,0,1979
51696,440721,BISNAGA 350 ML MOSTARDA,PLASDURAN,Em linha,R47-B05-A01-P02,1384,36,0,1348
24412,435448,PORTA CONDIMENTOS REDONDO C/05 PCS - 28X6X8 CMS,PLASDURAN,Em linha,R47-B10-A00-P02,279,15,90,264
56141,470609,SABONETEIRA 450 ML LIQUIDA PARIS ALCOOL GEL,PLASDURAN,Promocao,R47-B05-A02-P02,396,6,0,390
54951,440301,SABONETEIRA 450 ML LIQUIDA PARIS,PLASDURAN,Promocao,R47-B07-A02-P01,931,12,0,919
11135,400404,SABONETEIRA 300 ML LIQUIDA BOLA,PLASDURAN,Promocao,R48-B10-A02-P01,571,16,0,555
9048,430055,KIT C/ 04 PCS DE FUNIL,PLASDURAN,Em linha,R47-B05-A00-P02,989,75,0,914
57181,441372,FLOREIRA C/ALCA PRETA Ø21 X 38 CM,PLASDURAN,Lancamento,R47-B07-A01-P01,757,193,2400,564
32132,400401,PULVERIZADOR 300 ML BOLA,PLASDURAN,Promocao,R48-B10-A02-P02,1339,27,0,1312
54952,440302,PULVERIZADOR 450 ML PARIS,PLASDURAN,Promocao,R47-B08-A02-P03,1181,30,0,1151
39440,470158,PULVERIZADOR 650 ML ALADIM,PLASDURAN,Em linha,R47-B09-A02-P01,4497,0,0,4497
10846,430150,PULVERIZADOR 550 ML GIRAFA,PLASDURAN,Promocao,R48-B10-A02-P03,1629,132,0,1497
38212,430160,PULVERIZADOR 780ML GIRAFÃO,PLASDURAN,Em linha,R47-B05-A02-P01,2542,0,0,2542
56673,6600451010.00,DISNEY SUQUEIRA 3500 ML - MICKEY,TIBA LINE,Em linha,R46-B07-A01-P02,81,0,0,81
56674,6071451007.00,DISNEY GARRAFA TURQUEZA MICKEY 1800 ML,TIBA LINE,Em linha,R46-B10-A00-P02,188,6,0,182
56672,4604,DISNEY POTE ESPAGUETE PARIS MICKEY 1 KG,TIBA LINE,Em linha,R45-B09-A02-P03,251,0,0,251
56667,4605,DISNEY POTE PARIS MICKEY 3000 ML,TIBA LINE,Em linha,R45-B09-A02-P02,226,0,0,226
56669,4600,DISNEY POTE PARIS MICKEY 2100 ML,TIBA LINE,Em linha,R46-B01-A00-P02,272,12,0,260
56668,4601,DISNEY POTE PARIS MICKEY 1600 ML,TIBA LINE,Em linha,R46-B06-A01-P03,199,18,0,181
56670,4602,DISNEY POTE PARIS MICKEY 1250 ML,TIBA LINE,Promocao,R46-B10-A00-P03,244,6,72,238
56671,4603,DISNEY POTE PARIS MICKEY 600 ML,TIBA LINE,Promocao,R46-B03-A00-P02,211,0,0,211
56682,5000,DISNEY BALEIRO 2400 ML MICKEY,TIBA LINE,Em linha,R45-B10-A00-P01,240,6,0,234
56681,6124,"DISNEY BALEIRO 1,6 L MICKEY",TIBA LINE,Em linha,R45-B10-A02-P02,124,18,0,106
56684,6030,DISNEY BALEIRO 850 ML MICKEY,TIBA LINE,Em linha,R45-B10-A02-P01,134,12,0,122
56683,6156,DISNEY BALEIRO 250 ML MICKEY,TIBA LINE,Em linha,R46-B01-A00-P02,200,0,0,200
51732,6819452001.00,DISNEY POTE MULTIUSO 500 ML - MICKEY/MINNIE,TIBA LINE,Promocao,R46-B06-A00-P01,125,8,240,117
57222,4403451002.00,FRASCO APLICADOR DT 60 ML - MICKEY,TIBA LINE,Lancamento,R47-B03-A00-P01,640,5,0,635
57220,4402451002.00,FRASCO PUMP 60 ML - MICKEY,TIBA LINE,Lancamento,R47-B03-A00-P03,892,0,0,892
57218,4400451002.00,FRASCO SPRAY 60ML - MICKEY,TIBA LINE,Lancamento,R47-B03-A00-P02,775,11,0,764
57221,4411451002.00,FRASCO APLICADOR FT 100 ML - MICKEY,TIBA LINE,Lancamento,R47-B03-A00-P04,952,0,0,952
57219,4410451002.00,FRASCO SPRAY 100ML - MICKEY,TIBA LINE,Lancamento,R47-B04-A01-P01,826,0,0,826
48562,6506451001.00,GARRAFA SQUEEZE BOLA 250 ML CARETAS,TIBA LINE,Em linha,R46-B05-A00-P02,1494,18,0,1476
56680,6666451001.00,SUQUEIRA 3500 ML FLORAL,TIBA LINE,Em linha,R46-B07-A00-P03,70,0,0,70
52575,6665452001.00,POTE PARIS 3000 ML FLORAL,TIBA LINE,Em linha,R46-B07-A01-P01,130,14,180,116
52571,6660452001.00,POTE PARIS 2100 ML FLORAL,TIBA LINE,Promocao,R46-B06-A01-P01,246,0,240,246
52573,6662452001.00,POTE PARIS 1250 ML FLORAL,TIBA LINE,Em linha,R46-B05-A00-P01,457,0,0,457
52572,6661452001.00,POTE PARIS 1600 ML FLORAL,TIBA LINE,Promocao,R46-B06-A01-P02,244,6,300,238
51734,6620451001.00,GARRAFA GRASSA 1200 ML,TIBA LINE,Em linha,R46-B01-A01-P02,188,0,0,188
51735,6618451001.00,GARRAFA SOTTILE 1200 ML,TIBA LINE,Em linha,R46-B01-A01-P01,136,0,0,136
32478,6205452001.00,POTE GALINHAS 3000 ML,TIBA LINE,Em linha,R47-B02-A01-P02,670,36,600,634
32474,6200452001.00,POTE GALINHAS 2100 ML,TIBA LINE,Em linha,R47-B01-A01-P01,414,64,0,350
32475,6201452001.00,POTE GALINHAS 1600 ML,TIBA LINE,Promocao,R46-B04-A01-P01,655,76,360,579
32476,6202452001.00,POTE GALINHAS 1250 ML,TIBA LINE,Em linha,R46-B03-A01-P01,467,94,360,373
32477,6203452001.01,POTE GALINHAS 600 ML,TIBA LINE,Em linha,R46-B04-A00-P02,527,12,0,515
9795,4605452001.01,POTE CORUJAS 3000 ML,TIBA LINE,Em linha,R47-B02-A01-P01,122,9,720,113
9794,4600452001.01,POTE CORUJAS 2100 ML,TIBA LINE,Promocao,R46-B08-A01-P02,579,4,120,575
9525,4601452001.01,POTE CORUJAS 1600 ML,TIBA LINE,Promocao,R46-B09-A01-P03,1371,46,120,1325
9526,4602452001.01,POTE CORUJAS 1250 ML,TIBA LINE,Em linha,R46-B03-A01-P02,543,40,420,503
9527,4603452001.01,POTE CORUJAS 600 ML,TIBA LINE,Em linha,R46-B07-A00-P01,383,18,0,365
34183,6301452001.00,POTE PET 1600 ML,TIBA LINE,Em linha,R47-B01-A00-P03,844,18,0,826
34184,6302452001.00,POTE PET 3000 ML,TIBA LINE,Em linha,R47-B02-A01-P03,1386,18,0,1368
20426,6124452001.00,"BALEIRO 1,6 LITROS",TIBA LINE,Em linha,R46-B08-A01-P01,586,26,0,560
11653,6030452001.00,BALEIRO 850 ML,TIBA LINE,Em linha,R46-B03-A01-P03,524,30,0,494
56678,4128,POTE ESPAGUETEIRA JADE - DEGRADÊ,TIBA LINE,Em linha,R47-B02-A00-P02,113,0,0,113
56677,4127,POTE JADE 1000 ML - DEGRADÊ,TIBA LINE,Em linha,R46-B08-A00-P03,138,0,0,138
39536,6148452001.00,POTE VENEZA 2.200 ML,TIBA LINE,Em linha,R46-B09-A00-P01,529,24,0,505
39535,6147452001.00,POTE VENEZA 1.600 ML,TIBA LINE,Em linha,R46-B05-A00-P03,449,48,0,401
51741,6632452001.00,POTE VENEZA 2.200 ML C/ TPA METALIZADA,TIBA LINE,Em linha,R46-B02-A00-P01,178,12,120,166
51740,6631452001.00,POTE VENEZA 1.600 ML C/ TPA METALIZADA,TIBA LINE,Em linha,R46-B01-A00-P03,220,36,120,184
20430,6140451001.00,GARRAFA CRISTAL 1200 ML,TIBA LINE,Promocao,R46-B03-A00-P03,493,24,0,469
12198,6061451001.00,GARRAFA SLIM 1200 ML,TIBA LINE,Promocao,R45-B08-A00-P01,1557,86,2100,1471
12199,6062451001.00,GARRAFA FAT 1200 ML,TIBA LINE,Promocao,R46-B08-A01-P03,566,67,2100,499
39530,6166451001.00,GARRAFA VENEZA 1.500 ML,TIBA LINE,Em linha,R46-B01-A01-P03,373,0,0,373
35609,6191451001.00,GARRAFA SPORT 650 ML,TIBA LINE,Promocao,R46-B06-A00-P03,1560,2,120,1558
56679,6627,GARRAFA VENEZA 350 ML,TIBA LINE,Em linha,R45-B09-A02-P01,224,0,0,224
12318,6074451001.00,GARRAFA SQUEEZE CINTURADA 600 ML,TIBA LINE,Em linha,R46-B10-A01-P01,1376,54,0,1322
45406,6611451001.00,JARRA VENEZA C/ TAMPA 1800 ML,TIBA LINE,Em linha,R46-B02-A01-P01,204,6,0,198
45407,6612451001.00,JARRA VALSA C/ TAMPA 1800 ML,TIBA LINE,Em linha,R46-B04-A00-P01,1160,12,0,1148
8193,4130451001.00,FRASCO RUBI 1800 ML,TIBA LINE,Promocao,R46-B10-A00-P01,634,18,120,616
9528,2021451001.00,FRASCO SAFIRA 1500 ML,TIBA LINE,Promocao,R46-B05-A01-P03,577,12,0,565
8194,2080451001.00,FRASCO ESMERALDA 1500 ML,TIBA LINE,Promocao,R46-B05-A01-P02,375,12,540,363
8205,4261451001.00,FRASCO PEROLA 2000 ML,TIBA LINE,Promocao,R45-B09-A00-P01,2201,93,2100,2108
56203,6360452001.00,ORGANIZA MULTIDOSADOR 160 ML,TIBA LINE,Em linha,R46-B10-A01-P03,502,0,0,502
56204,6362452001.00,ORGANIZA MULTIDOSADOR 350 ML,TIBA LINE,Em linha,R46-B10-A01-P02,206,12,240,194
56202,6670452001.00,ORGANIZA MULTIUSO 160 ML,TIBA LINE,Em linha,R46-B04-A01-P02,610,0,0,610
56201,6672452001.00,ORGANIZA MULTIUSO 350 ML,TIBA LINE,Em linha,R46-B04-A01-P03,348,0,120,348
56200,6674452001.00,ORGANIZA MULTIUSO 540 ML,TIBA LINE,Em linha,R46-B04-A01-P04,417,0,0,417
56199,4340451001.00,RALADOR DUPLA FACE,TIBA LINE,Em linha,R46-B05-A01-P01,1287,0,0,1287
56210,4430451001.00,FRASCO SPRAY 240 ML - POÁ,TIBA LINE,Em linha,R47-B01-A00-P01,645,48,0,597
56211,4432451002.00,FRASCO PUMP 240 ML - POÁ,TIBA LINE,Em linha,R46-B09-A01-P01,639,48,0,591
56205,4400451001.00,FRASCO SPRAY 60 ML - POÁ,TIBA LINE,Em linha,R47-B01-A01-P02,1000,6,0,994
56207,4402451001.00,FRASCO PUMP 60 ML - POÁ,TIBA LINE,Em linha,R46-B04-A00-P03,1178,0,0,1178
56206,4403451001.00,FRASCO APLICADOR DT 60 ML - POÁ,TIBA LINE,Em linha,R47-B01-A01-P03,3280,0,0,3280
56209,4410451001.00,FRASCO SPRAY 100 ML - HIGIENE,TIBA LINE,Em linha,R46-B03-A00-P01,931,30,0,901
56208,4411451001.00,FRASCO APLICADOR FT 100 ML - HIGIENE,TIBA LINE,Em linha,R46-B02-A00-P01,602,5,240,597
16460,7000456002.00,PORTA CONDIMENTOS C/ 02 PCS 200 ML,TIBA LINE,Em linha,R46-B08-A00-P01,719,36,120,683
11089,7001456001.00,PORTA CONDIMENTOS C/ 02 PCS 500 ML,TIBA LINE,Em linha,R46-B07-A00-P02,1602,36,0,1566
42270,6505451001.00,PULVERIZADOR GIRAFA GRADUADO 550ML,TIBA LINE,Em linha,R46-B02-A01-P02,10705,0,0,10705
10294,5100451001.00,PULVERIZADOR 500 ML,TIBA LINE,Em linha,R46-B09-A01-P02,12479,0,0,12479
20425,6123451001.00,PULVERIZADOR BOLA 500 ML,TIBA LINE,Em linha,R47-B02-A00-P01,739,0,0,739
11837,6031451001.00,PULVERIZADOR BOLA 300 ML,TIBA LINE,Em linha,R46-B01-A00-P01,2484,10,0,2474
57211,6615452001.00,"VASO SEVILHA Ø14,5 X 28 CM ",TIBA LINE,Lancamento,R47-B03-A01-P03,556,6,120,550
57210,6613452001.00,"VASO VALÊNCIA Ø14,5 X 28 CM ",TIBA LINE,Lancamento,R47-B04-A00-P03,424,6,0,418
57216,6687452001.00,VASO GIRONA Ø14 X 20 CM ,TIBA LINE,Lancamento,R46-B08-A00-P02,843,12,120,831
57214,6682452001.00,VASO VALENCIA 790ML ,TIBA LINE,Lancamento,R47-B04-A01-P03,331,24,0,307
57215,6684452001.00,VASO SEVILHA 690ML ,TIBA LINE,Lancamento,R47-B03-A01-P01,787,36,120,751
57213,6646452001.00,"VASO FLORENÇA Ø10,5 X 10,3 CM ",TIBA LINE,Lancamento,R47-B04-A01-P02,321,36,180,285
17260,1714,GAVETEIRO PRETO C/03 GAVETAS PRATA - 46X33X53 CMS ,PLASNEW,Em linha,R49-B08-A02-P01,29,0,0,29
49948,71,CABIDE PRETO C/ 15 PCS,PLASNEW,Em linha,R48-B04-A00-P03,323,0,0,323
10404,69,CABIDE PRETO C/ 05  PCS,PLASNEW,Em linha,R50-B01-A00-P01,1839,40,0,1799
12257,7080,BALDE OVAL GRADUADO 8 LTS TRANS,PLASNEW,Em linha,R50-B02-A01-P03,404,25,0,379
12258,7135,"BALDE OVAL GRADUADO 13,5 LTS TRANS",PLASNEW,Em linha,R48-B03-A00-P01,338,20,0,318
12259,7018,BALDE OVAL GRADUADO 18 LTS TRANS,PLASNEW,Em linha,R48-B02-A00-P01,310,12,0,298
10413,177,"BALDE RETANGULAR 12,8 LTS",PLASNEW,Em linha,R48-B04-A01-P03,542,55,0,487
56571,201,BALDE 5L PRETO,PLASNEW,Em linha,R48-B01-A00-P02,218,10,0,208
7518,179,"BALDE 7,4 LTS",PLASNEW,Em linha,R50-B02-A00-P03,420,5,0,415
7519,180,"BALDE 13,6 LTS",PLASNEW,Em linha,R49-B09-A01-P04,444,0,0,444
7687,185,BALDE 20 LTS,PLASNEW,Em linha,R49-B09-A00-P02,194,0,0,194
49947,708,"CJ BACIA C/ 4 PC (1,3L-2,3L-4L-5L)",PLASNEW,Em linha,R49-B06-A02-P03,954,0,0,954
11504,36,BACIA OVAL 33 LTS,PLASNEW,Em linha,R48-B05-A00-P01,160,6,30,154
11505,37,BACIA OVAL 54 LTS,PLASNEW,Em linha,R49-B09-A00-P01,146,11,60,135
7520,178,BALDE CONCRETO GRADUADO 12 LTS,PLASNEW,Em linha,R48-B03-A00-P03,382,0,0,382
57184,292,LIXEIRA 8L INOX,PLASNEW,Lancamento,R49-B10-A01-P03,880,0,0,880
57183,392,LIXEIRA TAMPA MOVEL 8L INOX,PLASNEW,Lancamento,R48-B05-A00-P01,1384,3,0,1381
57182,390,LIXEIRA TAMPA MOVEL 8L COLOR,PLASNEW,Lancamento,R49-B10-A00-P03,1434,0,0,1434
42184,278    ,BALDE CONCRETO GRADUADO 20 LTS,PLASNEW,Em linha,R48-B03-A00-P02,293,0,0,293
10408,1518,CESTO FECHADO PRETO C/ TAMPA PRETA 27 LTS,PLASNEW,Em linha,R49-B06-A00-P01,651,14,0,637
10410,1520,CESTO FECHADO PRETO C/ TAMPA PRETA 53 LTS,PLASNEW,Em linha,R49-B07-A00-P02,459,15,0,444
10411,1521,CESTO FECHADO PRETO C/ TAMPA PRETA 97 LTS,PLASNEW,Em linha,R49-B08-A00-P01,887,26,0,861
22393,1921,CESTO FECHADO C/TAMPA BASCULANTE PRETO 97 LTS ,PLASNEW,Em linha,R49-B03-A00-P03,151,0,0,151
22392,1920,"CESTO FECHADO C/TAMPA BASCULANTE PRETO 53,3 LTS ",PLASNEW,Em linha,R49-B04-A00-P02,103,4,30,99
22391,1918,CESTO FECHADO C/TAMPA BASCULANTE PRETO 27 LTS ,PLASNEW,Em linha,R49-B06-A00-P03,142,0,0,142
52581,288,"LIXEIRA DE PIA TPA BASCULANTE 3,6L PRATA",PLASNEW,Em linha,R49-B07-A01-P01,306,12,0,294
13060,7541,LIXEIRA C/ PEDAL 40 LTS BRANCA,PLASNEW,Em linha,R49-B03-A02-P02,92,0,0,92
13059,7521,LIXEIRA C/ PEDAL 20 LTS BRANCA,PLASNEW,Em linha,R49-B07-A02-P02,247,0,0,247
13058,7513,LIXEIRA C/ PEDAL 12 LTS BRANCA,PLASNEW,Em linha,R49-B07-A02-P01,99,0,0,99
10412,804,ESCOVA SANITARIA C/ SUPORTE,PLASNEW,Em linha,R49-B01-A02-P01,5893,1002,600,4891
52583,753,CANTONEIRA PRETA,PLASNEW,Em linha,R48-B01-A02-P02,329,18,0,311
52582,752,CANTONEIRA PRATA,PLASNEW,Em linha,R48-B01-A02-P01,302,0,0,302
46836,1600,PALLET INDUSTRIAL PRETO - 60 CM X 50 CM X 6 CM,PLASNEW,Em linha,R49-B10-A00-P01,77,0,0,77
45338,8205,"CESTA DE MERCADO C/ ALCA METAL 21,4L VERMELHO",PLASNEW,Em linha,R49-B06-A02-P02,189,0,0,189
52593,8204,"CESTA DE MERCADO C/ ALCA METAL 21,4L PRATA",PLASNEW,Em linha,R49-B06-A02-P01,98,0,120,98
52594,9551,ORG EMPILHAVEL C/03 ANDAR PRETO-54X37X69CM,PLASNEW,Em linha,R49-B05-A02-P01,147,3,0,144
22398,8105,"CESTA DE MERCADO C/ ALCA PLASTICA 21,4L VERMELHA",PLASNEW,Em linha,R48-B01-A02-P03,1114,0,0,1114
52592,8104,"CESTA DE MERCADO C/ ALCA PLASTICA 21,4L PRATA",PLASNEW,Em linha,R49-B02-A02-P01,238,0,60,238
52584,2004,CAIXA DE SUP VERMELHA ( + DE 30 GRAV ),PLASNEW,Em linha,,144,0,0,144
52585,2005,CAIXA DE SUP PRETA ( + DE 30 GRAV ),PLASNEW,Em linha,,68,0,0,68
30378,9500,CESTA DE MERCADO MULTIUSO C/RODIZIO VERM 30 LTS,PLASNEW,Em linha,R49-B01-A02-P02,162,0,0,162
12150,2011,CAIXA FRIGORIFICA 42 LTS - 66X44X20 CMS,PLASNEW,Em linha,R49-B03-A02-P01,205,8,0,197
12149,2010,CAIXA FRIGORIFICA 38 LTS - 61X40X21 CMS,PLASNEW,Em linha,R49-B09-A02-P01,152,4,0,148
45708,425,CESTO OITAVADO EMPILHÁVEL COM 03 ANDARES PRETA,PLASNEW,Em linha,R48-B04-A02-P01,100,0,0,100
45711,428,CESTO TRIANGULAR EMPILHÁVEL COM 03 ANDARES PRETA,PLASNEW,Em linha,R48-B02-A02-P01,188,4,20,184
45709,426,CESTO RETANGULAR EMPILHÁVEL COM 03 ANDARES PRETA,PLASNEW,Em linha,R48-B03-A02-P02,196,6,0,190
45712,429,CESTO REDONDO EMPILHÁVEL COM 03 ANDARES PRETA,PLASNEW,Em linha,R49-B10-A02-P02,250,8,0,242
45710,427,CESTO QUADRADO EMPILHÁVEL COM 03 ANDARES PRETA,PLASNEW,Em linha,R49-B07-A02-P03,174,4,0,170
46833,446,CESTO RETANGULAR EMPILHÁVEL COM 03 ANDARES PRATA,PLASNEW,Em linha,R49-B10-A02-P01,210,4,0,206
46835,449,CESTO REDONDO EMPILHÁVEL COM 03 ANDARES PRATA,PLASNEW,Em linha,R50-B01-A02-P02,231,19,40,212
46834,447,CESTO QUADRADO EMPILHÁVEL COM 03 ANDARES PRATA,PLASNEW,Em linha,R50-B02-A02-P01,160,2,0,158
46831,445,CESTO OITAVADO EMPILHÁVEL COM 03 ANDARES PRATA,PLASNEW,Em linha,R50-B01-A02-P01,163,0,0,163
46832,448,CESTO TRIANGULAR EMPILHÁVEL COM 03 ANDARES PRATA,PLASNEW,Em linha,R48-B03-A02-P01,224,2,0,222
52577,41,CESTO RET TELADO 10 L PRETO,PLASNEW,Em linha,R48-B04-A00-P01,331,0,0,331
46826,2531,CESTO TELADO C/ TAMPA 30L PRETO - 39 X 44 CM,PLASNEW,Em linha,R49-B04-A00-P01,85,7,300,78
46828,2801,CESTO TELADO C/ TAMPA 56L PRETO - 44 X 64 CM,PLASNEW,Em linha,R49-B05-A00-P02,293,0,0,293
46830,2811,"CESTO TELADO TRIANGULAR C/ TAMPA 43,7L PRETO",PLASNEW,Em linha,R49-B03-A00-P01,157,3,0,154
52576,42,CESTO RET TELADO 10 L PRATA,PLASNEW,Em linha,R49-B09-A01-P01,1063,445,0,618
46825,2530,CESTO TELADO C/ TAMPA 30L PRATA - 39 X 44 CM,PLASNEW,Em linha,R49-B06-A00-P02,1761,888,0,873
46827,2800,CESTO TELADO C/ TAMPA 56L PRATA - 44 X 64 CM,PLASNEW,Em linha,R49-B03-A00-P02,308,15,90,293
46829,2810,"CESTO TELADO TRIANGULAR C/ TAMPA 43,7L PRATA",PLASNEW,Em linha,R49-B05-A00-P01,222,6,0,216
49952,2076,ORGANIZADOR RATTAN PRATA 42L,PLASNEW,Em linha,R49-B07-A00-P01,173,0,0,173
49951,2066,ORGANIZADOR RATTAN PRATA 17L,PLASNEW,Em linha,R48-B02-A00-P02,186,0,0,186
49950,2056,"ORGANIZADOR RATTAN PRATA 8,8L",PLASNEW,Em linha,R48-B04-A01-P02,156,0,0,156
49949,2046,"ORGANIZADOR RATTAN PRATA 5,8L",PLASNEW,Em linha,R49-B10-A00-P02,180,0,0,180
46942,9337,"CONTAINER ALTO 26 LTS - 47X35X25,5 CMS PRATA",PLASNEW,Em linha,R49-B02-A00-P03,136,0,0,136
46941,9377,CONTAINER BAIXO 20 LTS PRATA,PLASNEW,Em linha,R49-B02-A00-P01,1032,0,0,1032
46940,9327,"CONTAINER BAIXO 12,4 LTS PRATA",PLASNEW,Em linha,R49-B02-A00-P02,89,0,0,89
46945,9367,CONTAINER ALTO C/ RODIZIO 78L- 66X46X39CM PRATA,PLASNEW,Em linha,R49-B01-A00-P01,35,2,30,33
46944,9357,CONTAINER ALTO C/ RODIZIO 54 L-60X41X34CM PRATA,PLASNEW,Em linha,R49-B01-A00-P02,54,1,30,53
46943,9347,"CONTAINER ALTO 38,2 LTS - 53X38X29,5 CMS PRATA",PLASNEW,Em linha,R49-B01-A00-P03,139,1,0,138
35604,115,"VASO QUADR COLUNA MARMORIZADO 28,8 LTS-33X33X52 CM",PLASNEW,Em linha,R50-B01-A01-P04,73,0,0,73
35603,111,VASO QUADR COLUNA MARMORIZADO 19 LTS-29X29X44 CM,PLASNEW,Em linha,R48-B03-A01-P03,99,2,60,97
35602,107,VASO QUADR COLUNA MARMORIZADO 13 LTS-26X26X39 CM,PLASNEW,Em linha,R49-B09-A01-P03,161,0,0,161
56569,135,VASO QUADR COLUNA MARMORIZADO RATTAN 28 LTS,PLASNEW,Em linha,R48-B01-A01-P02,385,2,0,383
56567,131,"VASO QUADR COLUNA MARMORIZADO RATTAN 17,5 LTS",PLASNEW,Em linha,R48-B01-A01-P03,422,2,0,420
56565,127,VASO QUADR COLUNA MARMORIZADO RATTAN 10 LTS,PLASNEW,Em linha,R48-B01-A01-P01,310,0,120,310
56662,570,PRATO PARA VASO PRETO 41 CM,PLASNEW,Em linha,R49-B02-A02-P02,281,0,240,281
56661,566,PRATO PARA VASO PRETO 31 CM,PLASNEW,Em linha,R48-B01-A00-P01,492,0,120,492
56660,562,PRATO PARA VASO PRETO 27 CM,PLASNEW,Em linha,R48-B01-A00-P03,383,0,240,383
38071,119,VASO RED PRETO 44 LTS - 50X50X42 CMS ,PLASNEW,Em linha,R48-B04-A00-P02,95,3,30,92
7530,99,"VASO RED PRETO 21,5 LTS - 40X32.5X23 CMS ",PLASNEW,Em linha,R49-B09-A01-P02,533,6,0,527
7527,98,"VASO RED PRETO 14,5 LTS - 30X30X18 CMS",PLASNEW,Em linha,R50-B02-A01-P01,504,7,0,497
38068,118,"VASO QUADR COLUNA PRETO 28,8 LTS - 33X52X33 CMS ",PLASNEW,Em linha,R50-B01-A01-P03,408,6,0,402
38069,114,VASO QUADR COLUNA PRETO 19 LTS - 29X44X29 CMS ,PLASNEW,Em linha,R50-B01-A01-P02,369,6,0,363
38070,110,VASO QUADR COLUNA PRETO 13 LTS - 26X38X26 CMS,PLASNEW,Em linha,R48-B03-A01-P02,454,6,0,448
7524,15,"VASO QUADR PRETO - 33X28X17 CM / 14,5 LTS",PLASNEW,Em linha,R48-B03-A01-P01,296,28,120,268
35600,19,"VASO QUADR PRETO 6,3 LTS - 23X23X22 CMS",PLASNEW,Em linha,R48-B04-A01-P01,1247,34,0,1213
7521,13,"FLOREIRA PRETA - 47 CM / 9,5 LITROS",PLASNEW,Em linha,R48-B02-A00-P03,531,18,0,513
13062,104,VASO RED CERAMICO 44 LTS - 50X50X42 CMS ,PLASNEW,Em linha,R50-B02-A00-P02,58,0,0,58
35943,100,"VASO RED CERAMICO 21,5 LTS - 40X40X32 CMS",PLASNEW,Em linha,R48-B04-A01-P04,82,6,60,76
35952,96,"VASO RED CERAMICO 14,5 LTS - 33X33X29 CMS",PLASNEW,Em linha,R50-B02-A01-P02,683,9,0,674
35945,17,"VASO QUADR CERAMICO 14,5 LTS - 33X28X17 CMS",PLASNEW,Em linha,R49-B10-A01-P01,154,0,0,154
35601,21,"VASO QUADR CERAMICO 6,3 LTS - 23X23X22 CMS",PLASNEW,Em linha,R49-B10-A01-P02,879,6,0,873
17264,116,"VASO QUADR COLUNA CERAMICO 28,8 LTS - 33X52X33 CMS",PLASNEW,Em linha,R50-B01-A01-P01,404,0,0,404
17262,112,VASO QUADR COLUNA CERAMICO 19 LTS - 29X44X29 CMS,PLASNEW,Em linha,R50-B01-A00-P02,403,0,0,403
17263,108,VASO QUADR COLUNA CERAMICO 13 LTS - 26X38X26 CMS,PLASNEW,Em linha,R48-B03-A01-P04,452,1,0,451
56570,136,VASO QUADR COLUNA CERAMICO RATTAN 28 LTS,PLASNEW,Em linha,R48-B02-A01-P02,500,10,0,490
56568,132,"VASO QUADR COLUNA CERAMICO RATTAN 17,5 LTS",PLASNEW,Em linha,R48-B02-A01-P02,538,0,0,538
56566,128,VASO QUADR COLUNA CERAMICO RATTAN 10 LTS,PLASNEW,Em linha,R48-B02-A01-P01,834,222,90,612
56463,R20-02,CADEIRA BISTRO PRETA (SUPORTA ATÉ 140 KG),LIBERTY,Em linha,R49-B13-A00-P01,346,0,0,346
56461,R10-02,POLTRONA PRETA (SUPORTA ATÉ 140 KG),LIBERTY,Em linha,R48-B14-A00-P01,433,0,0,433
56465,R40-02,BANQUETA PRETA,LIBERTY,Em linha,R47-B14-A00-P01,421,0,0,421
56462,R20-01,CADEIRA BISTRO BRANCA (SUPORTA ATÉ 140 KG),LIBERTY,Em linha,R49-B14-A00-P01,910,36,0,874
56460,R10-01,POLTRONA BRANCA (SUPORTA ATÉ 140 KG),LIBERTY,Em linha,R48-B13-A00-P01,358,0,0,358
56464,R40-01,BANQUETA BRANCA,LIBERTY,Em linha,R47-B13-A00-P01,462,0,0,462
56467,R50-02,MESA PRETA 70 X 70 CM,LIBERTY,Em linha,R50-B13-A00-P01,154,0,0,154
56466,R50-01,MESA BRANCA 70 X 70 CM,LIBERTY,Em linha,R50-B14-A00-P01,169,12,0,157
17333,115297,CJ MANTIMENTO COLOR 05 PCS,INJETEMP,Em linha,R51-B09-A02-P01,75,12,0,63
51090,102200,ESCORREDOR MULTIUSO COM CABO 19 CM,INJETEMP,Em linha,R51-B05-A01-P04,661,4,0,657
57069,92.02,COPO GRADUADO C/ TAMPA 500 ML COLOR,INJETEMP,Lancamento,R51-B07-A00-P01,760,6,120,754
9486,108400,COPO GRADUADO C/ TAMPA 500 ML,INJETEMP,Em linha,R51-B04-A00-P01,1114,42,0,1072
56498,93.73,COPO GRADUADO 500 ML COLORS,INJETEMP,Em linha,R51-B05-A00-P03,3835,171,600,3664
1005,100900,COPO GRADUADO 500 ML,INJETEMP,Em linha,R51-B10-A00-P01,9033,416,960,8617
57068,93.76,JARRA GRADUADA 1 LT COLOR,INJETEMP,Lancamento,R51-B07-A01-P02,998,24,180,974
11799,014000,JARRA GRADUADA 1 LT ,INJETEMP,Em linha,R51-B10-A01-P04,929,38,180,891
57070,93.75,COPINHO GRADUADO CULINÁRIA 100 ML COLOR,INJETEMP,Lancamento,R51-B07-A01-P01,1310,108,480,1202
55949,11.99.00,COPINHO GRADUADO CULINÁRIA 100 ML,INJETEMP,Em linha,R51-B06-A01-P01,1192,100,0,1092
42130,103100,FORMA P/ RAVIOLI E MINI-PASTEL ,INJETEMP,Em linha,R51-B07-A00-P03,141,23,480,118
8175,009200,"FORMA PARA PUDIM ""PUDINZEIRA"" 1.8 LITROS",INJETEMP,Promocao,R51-B05-A00-P02,525,6,0,519
52503,025800,KIT TEMPERO C/ 03 PCS,INJETEMP,Em linha,R51-B06-A01-P03,45,6,180,39
54879,04.24,CJ P/ CAFÉ TAM 100 - MARROM,INJETEMP,Promocao,R51-B05-A01-P02,1393,0,0,1393
9487,108600,CJ FILTRO JULIANA - 13 x 12 CM,INJETEMP,Em linha,R51-B05-A02-P01,766,42,240,724
54881,10.92,PORTA FILTRO DE CAFÉ TAM. 103 - MARROM,INJETEMP,Em linha,R51-B09-A01-P01,2023,73,240,1950
22218,109300,ADAPTADOR P/ GARRAFA TERMICA,INJETEMP,Em linha,R51-B10-A01-P03,1426,6,480,1420
54878,04.23,FILTRO LONGA VIDA P/CAFE 100,INJETEMP,Em linha,R51-B06-A01-P02,690,48,0,642
54880,04.25,CJ P/ CAFÉ TAM 100 - COLOR,INJETEMP,Promocao,R51-B05-A01-P03,1162,4,0,1158
46882,208699,CJ FILTRO JULIANA COLOR - 13 x 12 CM,INJETEMP,Em linha,R51-B09-A02-P03,931,10,0,921
54883,97.18,PORTA FILTRO DE CAFÉ TAM. 103 - COLOR,INJETEMP,Em linha,R51-B09-A01-P02,879,6,0,873
1004,101900,FILTRO LONGA VIDA P/CAFE 103,INJETEMP,Em linha,R51-B05-A02-P02,6241,476,720,5765
7842,101800,FILTRO LONGA VIDA P/CAFE 102,INJETEMP,Em linha,R51-B08-A02-P03,312,107,1440,205
1006,101300,INJETOR DE TEMPEROS,INJETEMP,Em linha,R51-B07-A02-P04,384,8,0,376
4459,100000,DECORADOR DE BOLO,INJETEMP,Em linha,R51-B07-A00-P02,494,10,0,484
22213,010300,MINI ESPATULAS C/ 03 PCS,INJETEMP,Em linha,R51-B10-A01-P01,2122,76,0,2046
22214,013900,CJ COLHERINHAS MEDIDORAS,INJETEMP,Em linha,R51-B10-A01-P02,1703,53,0,1650
56499,10.58,KIT 02 COLHERES CABO LONGO 29 CM,INJETEMP,Em linha,R51-B06-A02-P03,946,72,0,874
56500,01.29,"KIT DECORE FÁCIL - 18,5 X 15 CM",INJETEMP,Promocao,R51-B05-A01-P01,584,11,180,573
55950,30.76,REGUA PARA DECORAÇÃO DE BOLO Nº 04,INJETEMP,Em linha,R51-B08-A01-P03,369,6,0,363
55951,30.78,REGUA PARA DECORAÇÃO DE BOLO Nº 06,INJETEMP,Em linha,R51-B08-A01-P02,392,6,0,386
55952,30.81,REGUA PARA DECORAÇÃO DE BOLO Nº 09,INJETEMP,Em linha,R51-B08-A01-P01,469,30,0,439
46880,037600,"JARRA ABACAXI NEW 1,5 LTS",INJETEMP,Em linha,R51-B06-A02-P02,890,19,0,871
12757,014600,"JARRA ABACAXI 1,5 LTS",INJETEMP,Em linha,R51-B09-A02-P02,1205,103,0,1102
34120,024000,ABACAXI C/ CANUDO 500 ML,INJETEMP,Em linha,R51-B07-A02-P03,612,12,0,600
48524,034600,COPO CANUDO 300 ML ABACAXI,INJETEMP,Em linha,R51-B06-A02-P01,743,40,0,703
36962,026400,SALEIRO DE MESA - ABACAXI - 130 ML,INJETEMP,Em linha,R51-B09-A00-P01,1922,219,0,1703
36963,026500,PALITEIRO DE MESA - ABACAXI - 130 ML,INJETEMP,Em linha,R51-B08-A00-P01,1355,126,0,1229
45358,032499,"JARRA SLEEVE DECORADO SORTIDO 1,6 L",INJETEMP,Em linha,R51-B08-A02-P01,448,6,0,442
46879,034199,"JARRA SLEEVE DECORADO TROPICAL 1,6 L",INJETEMP,Em linha,R51-B04-A02-P02,423,6,0,417
40570,028800,COPO CANUDO 650 ML SLEEVE ABACAXI,INJETEMP,Promocao,R51-B07-A01-P03,450,0,0,450
39699,028100,COPO CANUDO 650 ML SLEEVE MELANCIA,INJETEMP,Promocao,R51-B06-A00-P01,374,45,0,329
45354,031600,COPO CANUDO 650 ML SLEEVE ARANHA,INJETEMP,Em linha,R51-B07-A01-P04,380,0,0,380
40571,030100,COPO CANUDO 650 ML SLEEVE UNICORNIO,INJETEMP,Em linha,R51-B08-A01-P04,935,0,0,935
38024,979600,COPO CANUDO 600 MLUNICORNIO,INJETEMP,Em linha,R51-B04-A02-P01,655,37,0,618
8179,105400,COPO CHUQUINHA COM 2 ALCAS,INJETEMP,Em linha,R51-B05-A02-P03,396,12,0,384
17335,102100,KIT SORVETE ( BICHOLE ) C/ 06 PCS,INJETEMP,Em linha,R51-B08-A02-P02,3890,74,0,3816
42131,026700,"GARRAFAO FITNESS 1,8 L",INJETEMP,Em linha,R51-B06-A00-P02,1055,33,0,1022
11081,103397,LIXEIRA C/ PEDAL COLOR 04 LTS,INJETEMP,Em linha,R51-B05-A00-P01,199,0,0,199
56501,04.27,CESTO ORGANIZADOR MULTIUSO 24 X 16 X 12 CM,INJETEMP,Em linha,R51-B07-A02-P01,651,0,0,651
20354,014800,"PORTA SABAO EM PO C/ DOSADOR 1,6 KG",INJETEMP,Em linha,R51-B10-A02-P02,98,51,1200,47
20355,014700,PORTA SABAO EM PO C/ DOSADOR 1 KG,INJETEMP,Em linha,R51-B10-A02-P01,520,22,300,498
25601,620,"CORTINA P/ BOX VINIL VISOR ESTAMP-1,35X2,00 MTS",PLAST LEO,Em linha,R52-B08-A02-P02,721,10,120,711
33117,604,"CORTINA P/ BOX VINIL ESTAMPADA - 1,35X2,00 MTS",PLAST LEO,Em linha,R52-B07-A02-P03,360,6,60,354
33118,623,"CORTINA P/ BOX VINIL ESTAMP VISOR LISO-1,35X2,0 MT",PLAST LEO,Em linha,R52-B07-A02-P04,430,14,240,416
42189,621,"CORTINA P/ BOX VINIL VISOR LISO 1,35X2M",PLAST LEO,Em linha,R52-B04-A02-P03,387,18,0,369
39443,603,"CORTINA P/ BOX VINIL LISA 1,35X2,00M",PLAST LEO,Em linha,R52-B07-A02-P01,388,6,0,382
54922,640,"CORTINA P/ BOX VINIL C/ ILHOS 1,35 X 2,00 M",PLAST LEO,Em linha,R52-B05-A02-P03,185,5,0,180
54921,615,"CORTINA P/ BOX PE ESTAMPADA 1,35 X 1,78 M",PLAST LEO,Promocao,R52-B08-A02-P01,3859,97,1600,3762
54920,613,"CORTINA P/ BOX PE LISA 1,35 X 1,78 M",PLAST LEO,Promocao,R52-B09-A02-P03,2789,114,240,2675
25617,619,TOUCA TERMICA METALIZADA,PLAST LEO,Em linha,R52-B01-A02-P02,1030,6,0,1024
25612,607,TOUCA BANHO 02 PCS SANFONADA,PLAST LEO,Em linha,R52-B04-A02-P01,2255,198,360,2057
25602,916,CORTINA P/ PIA  ,PLAST LEO,Em linha,R52-B03-A02-P02,913,40,320,873
26833,989,FILTRO P/ COIFA 01 PC,PLAST LEO,Promocao,R52-B05-A02-P02,791,60,0,731
25607,526,LUVA TERMICA,PLAST LEO,Em linha,R52-B08-A02-P03,185,2,0,183
25594,933S,AVENTAL FLANELADO,PLAST LEO,Em linha,R52-B02-A02-P01,585,15,0,570
36861,963-DZS,AVENTAL PVC FORRADO - KORINO ESTAMPADO,PLAST LEO,Em linha,R52-B04-A02-P02,281,6,360,275
54924,482,COBRE ALIMENTOS 60 X 60 CM,PLAST LEO,Em linha,R52-B07-A02-P02,127,0,0,127
26838,418S,KIT SACO CONFEITAR + BICOS,PLAST LEO,Lancamento,R52-B05-A02-P03,494,31,0,463
56962,323,PUXA SACO DE RENDA COM FORRO,PLAST LEO,Lancamento,R52-B02-A02-P03,280,0,0,280
56961,918S,TOALHA DE GELADEIRA ESTAMPADA CJ C/ 3 PCS,PLAST LEO,Lancamento,R52-B06-A02-P04,591,117,0,474
25596,911S,CAPA P/ BOTIJAO GAS,PLAST LEO,Lancamento,R52-B02-A02-P03,577,48,0,529
54923,433,ORGANIZADOR PVC CRISTAL 28 X 18 CM,PLAST LEO,Em linha,R52-B03-A02-P01,112,0,0,112
38072,920,"CORTINA BLACK OUT PVC 1,4 X 2M - CINZA",PLAST LEO,Em linha,R52-B04-A02-P04,153,0,0,153
48492,417,MOSQUETEIRA ,PLAST LEO,Em linha,R52-B03-A02-P03,134,0,0,134
25604,520,FORRO TERMICO C/ ESPUMA UNIVERSAL,PLAST LEO,Em linha,R52-B08-A02-P04,158,12,300,146
26828,711/P,CAPA P/ MAQ POLIETILENO ESTAMP - P 57X63X91 CM,PLAST LEO,Em linha,R52-B06-A02-P03,180,6,60,174
26829,711/M,CAPA P/ MAQ POLIETILENO ESTAMP - M 62X65X91 CM,PLAST LEO,Em linha,R52-B06-A02-P02,239,26,360,213
26830,711/G,CAPA P/ MAQ POLIETILENO ESTAMP - G 69X66X91 CM,PLAST LEO,Em linha,R52-B06-A02-P01,269,42,600,227
36854,431,SACO PARA LAVAR SOUTIEN COM BOJO,PLAST LEO,Em linha,R52-B09-A02-P01,158,3,120,155
26831,730/P,CAPA P/ MAQ FLANELADA LISA - P  57X63X91 CM,PLAST LEO,Em linha,R52-B10-A02-P03,48,8,120,40
25599,730/M,CAPA P/ MAQ FLANELADA LISA - M  62X65X91 CM,PLAST LEO,Em linha,R52-B10-A02-P02,207,28,60,179
25600,730/G,CAPA P/ MAQ FLANELADA LISA - G  69X66X91 CM,PLAST LEO,Em linha,R52-B10-A02-P01,343,46,180,297
25608,388,SACO P/ LAVAR ROUPA C/ ZIPER,PLAST LEO,Em linha,R52-B05-A02-P01,647,29,0,618
42187,760/M,CAPA P/ MAQ PVC KORINO MEGA C/ ZÍPER M -62X65X91CM,PLAST LEO,Em linha,R52-B01-A02-P04,55,0,0,55
42186,760/G,CAPA P/ MAQ PVC KORINO MEGA C/ ZÍPER G -69X66X91CM,PLAST LEO,Em linha,R52-B01-A02-P03,87,0,0,87
33119,750/M,CAPA P/ MAQ MATELASSE-DUPLA FACE M 62X65X91 CM,PLAST LEO,Em linha,R52-B10-A02-P04,84,0,0,84
29321,750/G,CAPA P/ MAQ MATELASSE-DUPLA FACE G 69X66X91CM ,PLAST LEO,Em linha,R52-B09-A02-P02,114,0,0,114
57097,PNF01,PENEIRA FUNIL Ø12 CM,KEITA,Lancamento,R51-B03-A02-P02,1139,444,1000,695
57101,CB01,CABIDE CJ C/ 03 PÇS - 39 CM,KEITA,Lancamento,R52-B01-A01-P01,793,112,800,681
57098,KTPIA,KIT PIA C/ RODINHO E PORTA DETERGENTE ,KEITA,Lancamento,R52-B01-A01-P02,1024,39,100,985
52805,JAR01,"JARRA 1,8L",KEITA,Lancamento,R51-B02-A01-P03,396,0,0,396
57100,FIL02,KIT FILTRO P/ CAFÉ INDIVIDUAL C/ 02 PÇS,KEITA,Lancamento,R52-B01-A02-P01,769,36,0,733
57096,COA01,"COADOR DE CAFÉ INDIVIDUAL - 10,7 X 3,5 X 16,6 CM",KEITA,Lancamento,R51-B02-A01-P04,318,12,0,306
51177,MULT05,MULTICORTADOR 5 LÂMINAS,KEITA,Em linha,R51-B01-A01-P02,80,0,48,80
38282,TM01,FATIADOR DE TOMATE,KEITA,Em linha,R51-B01-A02-P03,137,0,0,137
40598,KP02,KIT 4 EM 1,KEITA,Em linha,R51-B03-A02-P01,546,6,0,540
51179,CR02,CORTADOR E RALADOR DE LEGUMES BLISTER,KEITA,Em linha,R51-B03-A02-P03,652,17,2100,635
10444,CD01,CORTADOR DUPLA FACE,KEITA,Em linha,R51-B01-A02-P02,2075,121,800,1954
29360,CR01,CORTADOR E RALADOR DE LEGUMES CAIXA,KEITA,Em linha,R51-B02-A02-P01,947,12,100,935
56266,MT01,MULTI TRITURADOR 3 LAMINAS 500 ML,KEITA,Em linha,R51-B03-A01-P01,194,6,200,188
56659,RC01,RASPA COCO,KEITA,Em linha,R51-B03-A01-P02,263,18,500,245
12759,CX03,KIT COXINHAS C/ 03 UNIDADES,KEITA,Em linha,R51-B02-A01-P01,459,13,0,446
52804,CBP02,CORTADOR DE BATATA PALITO,KEITA,Em linha,R51-B01-A01-P03,340,12,50,328
11119,FP03,CJ FORMAS P/ PASTEL C/ 03 PCS,KEITA,Em linha,R51-B01-A01-P01,583,0,60,583
10447,FC01,FURA COCO,KEITA,Em linha,R51-B03-A01-P03,526,12,0,514
10449,PEP01,PEGA PALITO,KEITA,Em linha,R52-B01-A01-P03,131,0,0,131
22244,PRA01,PROCESSADOR DE ALHO,KEITA,Em linha,R51-B02-A02-P02,1057,4,0,1053
14200,DF05,DESCASCADOR E FATIADOR 5 X 1 CAIXA,KEITA,Em linha,R51-B02-A02-P03,1032,36,500,996
51178,DF05P,DESCASCADOR E FATIADOR 5 X 1 BLISTER,KEITA,Em linha,R51-B01-A02-P04,1291,14,0,1277
10445,DB02,DESCASCADOR E BOLEADOR,KEITA,Em linha,R51-B01-A02-P01,3091,310,2000,2781
11120,DM01,DESCASCADOR CABO DE MADEIRA,KEITA,Em linha,R51-B02-A01-P02,406,0,100,406
55940,201,EUCALIPTO - TÁBUA OVAL C/ CANALETA 30 X 20 CM,MADLAR,Em linha,R52-B05-A01-P03,146,0,0,146
55939,200,EUCALIPTO - TÁBUA RETANGULAR 30 X 20 CM,MADLAR,Em linha,R52-B09-A00-P01,157,0,0,157
55941,202,EUCALIPTO - TÁBUA RETANGULAR C/ ALÇA 36 X 22 CM,MADLAR,Em linha,R52-B02-A01-P01,115,0,72,115
55936,203,"EUCALIPTO - TÁBUA PARA CARNE 36,5 X 18,5 CM",MADLAR,Em linha,R52-B02-A01-P02,109,6,0,103
55937,204,"EUCALIPTO - TÁBUA PARA CARNE 39,5 X 21,6 CM",MADLAR,Em linha,R52-B04-A00-P01,85,2,72,83
55938,205,"EUCALIPTO - TÁBUA PARA CARNE 42,5 X 24,6 CM",MADLAR,Em linha,R52-B04-A01-P02,92,0,120,92
51764,00000062,TÁBUA OVAL C/ CANALETA 45 X 27 CM,MADLAR,Em linha,R52-B09-A01-P02,265,0,0,265
51755,00000155,PRATO REDONDO C/ CANALETA 25 CM,MADLAR,Em linha,R52-B04-A01-P01,273,0,0,273
51765,00000052,TÁBUA RETANGULAR 37 X 27 CM,MADLAR,Em linha,R52-B09-A01-P01,377,0,0,377
51773,00000900,KIT TÁBUA 15 X 32 CM + BATE BIFE,MADLAR,Em linha,R52-B09-A01-P03,244,6,0,238
51759,00000031,TÁBUA PARA CARNE 15 X 30 CM,MADLAR,Em linha,R52-B05-A00-P01,1194,15,0,1179
51760,00000033,TÁBUA PARA CARNE 15 X 35 CM,MADLAR,Em linha,R52-B05-A00-P02,1707,69,0,1638
51761,00000034,TÁBUA PARA CARNE 17 X 37 CM,MADLAR,Em linha,R52-B05-A00-P03,2675,69,0,2606
51762,00000035,TÁBUA PARA CARNE 19 X 39 CM,MADLAR,Em linha,R52-B06-A00-P03,1265,89,120,1176
51763,00000036,TÁBUA PARA CARNE 22 X 43 CM,MADLAR,Em linha,R52-B06-A00-P02,1809,28,0,1781
51774,00000903,KIT TÁBUA 15 X 32 CM + PILÃO 8 CM,MADLAR,Em linha,R52-B04-A01-P03,247,6,0,241
51771,00000904,KIT TÁBUA 15 X 32 CM + COLHER + SOCADOR,MADLAR,Em linha,R52-B05-A01-P02,221,6,0,215
51776,00000909,KIT ROLO DE MASSA 38 CM + SOCADOR 15 CM,MADLAR,Em linha,R52-B10-A01-P03,216,0,0,216
51775,00000911,KIT BATE BIFE + SOCADOR + COLHER 23 CM,MADLAR,Em linha,R52-B06-A01-P02,255,0,0,255
51768,00000902,KIT COLHER 26CM + 30CM + 34 CM,MADLAR,Em linha,R52-B06-A01-P03,277,3,0,274
51769,00000905,KIT COLHER 26CM + 30CM + PÁ 30 CM,MADLAR,Em linha,R52-B05-A01-P04,218,0,0,218
51767,00000099,MESA PARA CAFÉ,MADLAR,Em linha,R52-B09-A00-P03,160,0,0,160
51766,00000098,BANDEJA PARA CAFÉ,MADLAR,Em linha,R52-B10-A00-P01,127,0,0,127
51754,00000044,PRATELEIRA RETA 15 X 50CM,MADLAR,Em linha,R52-B05-A01-P01,252,0,0,252
51751,00000159,CJ DE ESTEIRAS C/ 03 PCS,MADLAR,Em linha,R52-B10-A00-P02,366,12,60,354
51743,00000011,COLHER DE MADEIRA 23 CM ENCARTELADA,MADLAR,Em linha,R52-B08-A01-P01,540,12,0,528
51969,00000001,COLHER DE MADEIRA 23 CM,MADLAR,Em linha,R52-B06-A00-P01,478,0,400,478
51749,00000021,COLHER DE MADEIRA 60 CM,MADLAR,Em linha,R52-B03-A01-P02,162,0,0,162
51744,00000013,COLHER DE MADEIRA 26 CM ENCARTELADA,MADLAR,Em linha,R52-B08-A01-P02,725,40,0,685
51970,00000002,COLHER DE MADEIRA 26 CM,MADLAR,Em linha,R52-B07-A00-P01,759,27,200,732
51745,00000015,COLHER DE MADEIRA 30 CM ENCARTELADA,MADLAR,Em linha,R52-B08-A01-P03,586,24,1000,562
51971,00000003,COLHER DE MADEIRA 30 CM,MADLAR,Em linha,R52-B07-A00-P02,1106,35,200,1071
51746,00000016,COLHER DE MADEIRA 34 CM ENCARTELADA,MADLAR,Em linha,R52-B03-A01-P02,887,40,400,847
51972,00000004,COLHER DE MADEIRA 34 CM,MADLAR,Em linha,R52-B07-A00-P03,1157,36,400,1121
51747,00000017,COLHER DE MADEIRA 38 CM ENCARTELADA,MADLAR,Em linha,R52-B07-A01-P02,985,20,600,965
51973,00000005,COLHER DE MADEIRA 38 CM,MADLAR,Em linha,R52-B08-A00-P02,579,41,600,538
51748,00000018,COLHER DE MADEIRA 45 CM ENCARTELADA,MADLAR,Em linha,R52-B07-A01-P01,340,6,300,334
51974,00000006,COLHER DE MADEIRA 45 CM,MADLAR,Em linha,R52-B08-A00-P01,451,12,300,439
51753,00000102,PILÃO C/ SOCADOR 12 CM,MADLAR,Em linha,R52-B10-A01-P02,471,13,560,458
51757,00000107,ROLO PARA MASSA 38 CM,MADLAR,Em linha,R52-B03-A01-P01,946,6,450,940
51758,00000106,ROLO PARA MASSA 43 CM,MADLAR,Em linha,R52-B09-A00-P02,2265,73,480,2192
56250,1151/10,"MANGUEIRA TRANCADA GARDELO 7/16"" POP CRISTAL 10M",MANGUEPLAST,Em linha,R52-B01-A00-P04,80,6,0,74
56254,5010/10,"MANGUEIRA TRANCADA REFORCADA LARANJA 1/2"" 10M",MANGUEPLAST,Em linha,R52-B03-A00-P04,37,0,0,37
56251,1151/15,"MANGUEIRA TRANCADA GARDELO 7/16"" POP CRISTAL 15M",MANGUEPLAST,Em linha,R52-B01-A00-P03,183,6,0,177
56255,5010/15,"MANGUEIRA TRANCADA REFORCADA LARANJA 1/2"" 15M",MANGUEPLAST,Em linha,R52-B03-A00-P03,41,0,0,41
56252,1151/20,"MANGUEIRA TRANCADA GARDELO 7/16"" POP CRISTAL 20M",MANGUEPLAST,Em linha,R52-B01-A00-P02,117,4,0,113
56248,1150/20,"MANGUEIRA TRANCADA GARDELO 7/16"" POP VERDE 20M",MANGUEPLAST,Em linha,R52-B02-A00-P02,63,0,0,63
56256,5010/20,"MANGUEIRA TRANCADA REFORCADA LARANJA 1/2"" 20M",MANGUEPLAST,Em linha,R52-B03-A00-P02,33,0,0,33
56253,1151/30,"MANGUEIRA TRANCADA GARDELO 7/16"" POP CRISTAL 30M",MANGUEPLAST,Em linha,R52-B01-A00-P01,101,2,0,99
56257,5010/30,"MANGUEIRA TRANCADA REFORCADA LARANJA 1/2"" 30M",MANGUEPLAST,Em linha,R52-B04-A00-P02,23,0,0,23
57017,50101,TAPETE HIGIÊNICO CONFORT PADS - 80X60CM - 07 UND,FURACÃO PET,Lancamento,R50-B02-A00-P01,2368,12,0,2356
57018,50001,TAPETE HIGIÊNICO CONFORT PADS - 60X55CM - 07 UND,FURACÃO PET,Lancamento,R50-B03-A00-P01,1809,394,0,1415
56598,0343,CASINHA N2 - AZUL - 52 X 41 X 40 CM,FURACÃO PET,Em linha,R50-B10-A00-P02,33,0,0,33
56596,0205,CASINHA N1 - AZUL - 48 X 38 X 36 CM,FURACÃO PET,Em linha,R50-B03-A00-P01,59,0,0,59
56599,0345,CASINHA N2 - ROSA - 52 X 41 X 40 CM,FURACÃO PET,Em linha,R50-B10-A00-P01,34,0,0,34
56597,0250,CASINHA N1 - ROSA - 48 X 38 X 36 CM,FURACÃO PET,Em linha,R50-B03-A00-P02,62,0,0,62
56594,0511,"CAIXA DE TRANSP LUXO N2 - AZUL - 47 X 34,5 X 30,5 CM",FURACÃO PET,Em linha,R50-B05-A00-P01,70,0,0,70
56592,0517,"CAIXA DE TRANSP LUXO N1 - AZUL - 43 X 30 X 28,5 CM",FURACÃO PET,Em linha,R50-B05-A02-P01,95,0,0,95
56649,01078,TOCA DO GATO PARIS - AZUL - 32 X 39 X 51 CM,FURACÃO PET,Em linha,R50-B08-A00-P01,73,0,0,73
56595,0513,"CAIXA DE TRANSP LUXO N2 - ROSA - 47 X 34,5 X 30,5 CM",FURACÃO PET,Em linha,R50-B07-A00-P02,71,0,0,71
56593,0519,"CAIXA DE TRANSP LUXO N1 - ROSA - 43 X 30 X 28,5 CM",FURACÃO PET,Em linha,R50-B09-A00-P01,97,0,0,97
56650,01081,TOCA DO GATO PARIS - ROSA - 32 X 39 X 51 CM,FURACÃO PET,Em linha,R50-B07-A00-P01,73,0,0,73
56574,0214,BANHEIRA GATO CLASSIC - AZUL - 47 X 37 X 11 CM,FURACÃO PET,Em linha,R50-B04-A02-P03,184,0,0,184
56575,0217,BANHEIRA GATO CLASSIC - ROSA - 47 X 37 X 11 CM,FURACÃO PET,Em linha,R50-B03-A02-P02,186,0,0,186
56576,01001,BANHEIRA GATO CLASSIC PLUS AZUL - 48 X 37 X 16 CM,FURACÃO PET,Em linha,R50-B06-A00-P01,121,0,0,121
56577,01004,BANHEIRA GATO CLASSIC PLUS ROSA - 48 X 37 X 16 CM,FURACÃO PET,Em linha,R50-B06-A00-P02,94,0,0,94
56578,0694,BANHEIRA GATO POP - AZUL - 47 X 37 X 11 CM,FURACÃO PET,Em linha,R50-B09-A02-P03,166,0,0,166
56579,0698,BANHEIRA GATO POP - ROSA - 47 X 37 X 11 CM,FURACÃO PET,Em linha,R50-B06-A02-P02,182,0,0,182
56647,0829,"SUPER CAT RELAX POP AZUL - 44 X 39 X 4,4 CM",FURACÃO PET,Em linha,R50-B05-A00-P02,125,0,0,125
56648,0830,"SUPER CAT RELAX POP ROSA - 44 X 39 X 4,4 CM",FURACÃO PET,Em linha,R50-B03-A02-P01,121,0,0,121
56635,0645,KIT P/ GATOS POP C/ 3 PECAS,FURACÃO PET,Em linha,R50-B05-A02-P02,39,0,120,39
56651,01270,XIXI FACIL POP - 59 X 44 CM,FURACÃO PET,Em linha,R50-B08-A00-P02,57,0,0,57
56652,01271,XIXI FACIL POP - COM GRAMA - 58 X 44 CM,FURACÃO PET,Em linha,R50-B06-A02-P01,36,0,0,36
56573,0212,ARRANHADOR DE PAPELAO P/ GATO,FURACÃO PET,Em linha,R50-B09-A00-P02,50,0,0,50
56605,0790,CJ GUIA SEDA C/ PEITORAL AJUST N1,FURACÃO PET,Em linha,R50-B05-A01-P03,109,0,0,109
56632,0019,GUIA DE CORDA ROLICA FINA 1 M - 10 MM,FURACÃO PET,Em linha,R50-B07-A01-P04,153,0,0,153
56604,0703,"CINTO DE SEGURANCA SIMPLES - MOSQ M - 1,5 CM",FURACÃO PET,Em linha,R50-B03-A01-P05,235,0,0,235
56606,0791,CJ GUIA SEDA C/ PEITORAL AJUST N2,FURACÃO PET,Em linha,R50-B06-A01-P05,109,0,0,109
56634,0015,GUIA DE CORDA ROLICA GROSSA 60 CM - 16 MM,FURACÃO PET,Em linha,R50-B04-A01-P04,133,1,0,132
56607,0792,CJ GUIA SEDA C/ PEITORAL AJUST N3,FURACÃO PET,Em linha,R50-B05-A01-P04,163,0,0,163
56633,0016,GUIA DE CORDA ROLICA GROSSA 1 M - 16 MM,FURACÃO PET,Em linha,R50-B04-A01-P03,117,0,0,117
56603,0704,"CINTO DE SEGURANCA SIMPLES - MOSQ G - 2,5 CM",FURACÃO PET,Em linha,R50-B05-A01-P01,105,0,0,105
56643,0018,"GUIA DE CORDA ROLICA GROSSA 1,50 M - 16 MM",FURACÃO PET,Em linha,R50-B03-A01-P04,129,0,0,129
56629,01357,FONTE JOY CAES E GATOS 110V - AZUL,FURACÃO PET,Em linha,R50-B08-A02-P01,37,0,0,37
56630,01358,FONTE JOY CAES E GATOS 110V - ROSA,FURACÃO PET,Em linha,R50-B07-A02-P03,37,0,0,37
56646,0498,REFIL FILTRO FONTE,FURACÃO PET,Em linha,R50-B05-A01-P05,99,0,0,99
56615,01229,COMEDOURO GATO SUPER CAT - 200 ML - Ø21 X 10 CM,FURACÃO PET,Em linha,R50-B09-A01-P05,140,0,0,140
56612,0626,COMEDOURO CARA DO GATO 200 ML - 15 X 18 X 6 CM,FURACÃO PET,Em linha,R50-B10-A01-P04,1378,444,360,934
56614,0156,COMEDOURO GATO ANTI-FORMIGA 200 ML - Ø15 X 4 CM,FURACÃO PET,Em linha,R50-B06-A01-P02,186,0,0,186
56628,01234,COMEDOURO POP GATO DUPLO 190 ML - 31 X 15 X 4 CM,FURACÃO PET,Em linha,R50-B10-A01-P01,768,0,0,768
56602,01288,CATA CACA - 9 X 10 X 4 CM,FURACÃO PET,Em linha,R50-B05-A02-P03,272,0,0,272
56580,01050,BEBEDOURO PARIS N2 - 700 ML - Ø9 X 9 CM,FURACÃO PET,Em linha,R50-B03-A01-P01,1880,432,288,1448
56581,01055,"BEBEDOURO PARIS N4 - 1,6L - Ø25 X 8 CM",FURACÃO PET,Em linha,R50-B10-A02-P01,1666,432,312,1234
56619,01067,COMEDOURO PARIS N2 - 850 ML  - Ø19 X 7 CM,FURACÃO PET,Em linha,R50-B10-A01-P02,1347,436,360,911
56620,01072,"COMEDOURO PARIS N4 - 1,9L - Ø25 X 8 CM",FURACÃO PET,Em linha,R50-B03-A02-P03,966,432,600,534
56624,0391,COMEDOURO POP N1 - 300 ML  - Ø14 X 4 CM,FURACÃO PET,Em linha,R50-B08-A01-P04,172,12,120,160
56625,0392,COMEDOURO POP N2 - 600 ML  - Ø19 X 6 CM,FURACÃO PET,Em linha,R50-B06-A01-P03,669,9,0,660
56626,0393,COMEDOURO POP N3 - 1L - Ø24 X 7 CM,FURACÃO PET,Em linha,R50-B10-A01-P03,129,0,0,129
56627,0616,"COMEDOURO POP N4 - 1,9L - Ø26 X 8 CM",FURACÃO PET,Em linha,R50-B07-A02-P01,793,3,0,790
56608,0160,COMEDOURO ANTI-FORMIGA N1 - 350 ML - Ø18 X 5 CM,FURACÃO PET,Em linha,R50-B06-A01-P01,189,0,0,189
56609,0292,COMEDOURO ANTI-FORMIGA N2 - 550 ML - Ø19 X 6 CM,FURACÃO PET,Em linha,R50-B10-A01-P05,253,0,0,253
56610,0707,COMEDOURO ANTI-FORMIGA N3 - 1L - Ø24 X 8 CM,FURACÃO PET,Em linha,R50-B09-A02-P01,152,0,0,152
56611,0747,"COMEDOURO ANTI-FORMIGA N4 - 1,9L - Ø28 X 9 CM",FURACÃO PET,Em linha,R50-B03-A01-P03,118,0,0,118
56616,01200,COMEDOURO GLAMOUR (ANTIDERRAPANTE) N1 - 260 ML - Ø16 X 5 CM,FURACÃO PET,Em linha,R50-B04-A01-P02,556,12,0,544
56617,01205,COMEDOURO GLAMOUR (ANTIDERRAPANTE) N2 - 500 ML - Ø20 X 6 CM,FURACÃO PET,Em linha,R50-B03-A01-P02,269,12,0,257
56618,01210,COMEDOURO GLAMOUR (ANTIDERRAPANTE) N3 - 1L - Ø24 X 7 CM,FURACÃO PET,Em linha,R50-B06-A01-P04,59,0,0,59
56582,0153,BEBEDOURO POP PELOS LONGOS N3 - 1L - Ø21 X 6 CM,FURACÃO PET,Em linha,R50-B10-A02-P03,274,0,0,274
56621,01239,COMEDOURO POP DUPLO N1 - 500 ML - 27 X 14 X 5 CM,FURACÃO PET,Em linha,R50-B07-A02-P02,208,0,0,208
56623,01249,COMEDOURO POP DUPLO N3 - 2L - 43 X 22 X 7 CM,FURACÃO PET,Em linha,R50-B10-A02-P02,82,0,0,82
56622,01244,"COMEDOURO POP DUPLO N2 - 1,1L - 36 X 18 X 6 CM",FURACÃO PET,Em linha,R50-B08-A02-P03,235,0,0,235
56636,0602,OSSO SUPERBONE BORRACHA N1 - 10 CM,FURACÃO PET,Em linha,R50-B04-A02-P02,164,0,0,164
56637,0601,OSSO SUPERBONE BORRACHA N2 - 14 CM,FURACÃO PET,Em linha,R50-B08-A01-P01,90,0,0,90
56638,0600,OSSO SUPERBONE BORRACHA N3 - 18 CM,FURACÃO PET,Em linha,R50-B09-A01-P03,50,0,0,50
56639,0112,OSSO TOPBONE BORRACHA N1 - 9 CM,FURACÃO PET,Em linha,R50-B09-A02-P02,177,0,0,177
56640,0113,OSSO TOPBONE BORRACHA N2 - 11 CM,FURACÃO PET,Em linha,R50-B05-A01-P02,338,0,0,338
56641,0114,OSSO TOPBONE BORRACHA N3 - 13 CM,FURACÃO PET,Em linha,R50-B06-A02-P03,121,0,0,121
56645,0416,PNEU OFF ROAD DOG BORRACHA N3 - Ø15 CM,FURACÃO PET,Em linha,R50-B09-A01-P04,37,0,0,37
56644,0418,PNEU OFF ROAD DOG BORRACHA N2 - Ø13 CM,FURACÃO PET,Em linha,R50-B07-A01-P01,156,0,0,156
56631,0473,GALHO BORRACHA MACICO 19 CM,FURACÃO PET,Em linha,R50-B07-A01-P03,172,0,0,172
56588,01282,"BOLA MACICA COLORIDA METEORO 4,5 CM",FURACÃO PET,Em linha,R50-B09-A01-P01,161,0,0,161
56589,01283,BOLA MACICA COLORIDA METEORO 6 CM,FURACÃO PET,Em linha,R50-B04-A02-P01,148,0,0,148
56590,01284,BOLA MACICA COLORIDA METEORO 8 CM,FURACÃO PET,Em linha,R50-B07-A01-P02,75,0,0,75
56583,0241,"BOLA MACICA COLORIDA 4,5 CM",FURACÃO PET,Em linha,R50-B07-A01-P05,235,0,0,235
56584,0239,"BOLA MACICA COLORIDA 5,5 CM",FURACÃO PET,Em linha,R50-B09-A01-P02,142,0,120,142
56586,0370,BOLA MACICA COLORIDA DOGAO 8 CM,FURACÃO PET,Em linha,R50-B08-A01-P05,46,0,0,46
56587,0326,"BOLA MACICA COLORIDA MAMONINHA 4,5 CM",FURACÃO PET,Em linha,R50-B08-A01-P03,228,0,0,228
56585,0417,BOLA MACICA COLORIDA CRAVO 7 CM,FURACÃO PET,Em linha,R50-B04-A01-P01,93,0,0,93
56591,0981,BOLA MACICA COLORIDA SUPER BALL 6 CM,FURACÃO PET,Em linha,R50-B05-A01-P06,87,0,0,87
56642,0321,OVO MACICO DE BORRACHA - 9 X 3 CM,FURACÃO PET,Em linha,R50-B08-A01-P02,327,0,0,327
25082,202005,ACENDEDOR FLAMA,LUME,Em linha,R51-B04-A01-P02,1992,12,0,1980
7922,200001,ACENDEDOR LUME,LUME,Em linha,R51-B04-A01-P01,10543,426,0,10117
38010,N 313,ESPELHO OVAL MOLDURA DE PLASTICO - 24CM X 32CM,BUDEPLAST,Em linha,R51-B03-A00-P02,108,48,0,60
42057,N20,ESPELHO MOLDURA PLASTICA - N 20 - 21X31 CM,BUDEPLAST,Em linha,R51-B03-A00-P01,1644,168,0,1476
37155,N18,ESPELHO MOLDURA PLASTICA - N 18 - 18X25 CM,BUDEPLAST,Em linha,R51-B02-A00-P01,1992,264,0,1728
37154,N16,ESPELHO MOLDURA PLASTICA - N 16 - 16X23 CM,BUDEPLAST,Em linha,R51-B02-A00-P02,3264,384,0,2880
37153,N14,ESPELHO MOLDURA PLASTICA - N 14 - 14X20 CM,BUDEPLAST,Em linha,R51-B01-A00-P03,5016,360,0,4656
38008,N10,ESPELHO MOLDURA PLASTICA - N 10 - 12X16 CM,BUDEPLAST,Em linha,R51-B01-A00-P01,948,108,0,840
14057,9000003,TORNEIRA P/ SUPORTE E FILTRO,MADRI,Em linha,R52-B14-A01-P01,615,31,0,584
8186,2001,SUP P/GARRAFAO DE AGUA - CUBA CERAMICA,MADRI,Em linha,R52-B13-A00-P01,629,16,0,613
8242,1001,SUP P/GARRAFAO DE AGUA - CUBA PLASTICO,MADRI,Em linha,R52-B13-A00-P03,1063,35,0,1028
14056,2201,SUP P/GARRAFAO DE AGUA C/ FILTRO - CUBA CER,MADRI,Em linha,R52-B14-A00-P01,88,2,0,86
9653,3001,SUP P/GARRAFAO DE AGUA INOX - CUBA CERAMICA,MADRI,Em linha,R52-B13-A00-P02,262,6,0,256
11233,2501,SUP P/GARRAFAO DE AGUA DECORADA- CUBA CERAMICA,MADRI,Em linha,R52-B14-A00-P02,126,3,0,123
52756,10770,TUBO DEC 16 X 10 CM COM TAMPA,BRUXELAS,Ponta de Estoque,R18-B24-A00-P01,588,0,0,588
52757,10771,TUBO DEC 16 X 20 CM COM TAMPA,BRUXELAS,Ponta de Estoque,R18-B24-A00-P01,30,0,0,30